Form	Hyphenation

# SPDX-License-Identifier: Unicode-DFS-2016

acara	aca➊ra
adalah	ada➊lah
adanya	ada➊nya
agama	aga➊ma
agenda	agen➊da
Agustus	Agus➊tus
ahli	ah➊li
Airbus	air➊bus
akhirnya	akhir➊nya
akibat	aki➊bat
akibatnya	aki➋bat➊nya
akses	ak➊ses
aksi	ak➊si
aktif	ak➊tif
aktivis	ak➊ti➊vis
aktivitas	ak➊ti➊vi➊tas
alami	ala➊mi
alasan	alas➊an
Alasannya	Alas➊an➊nya
aliansi	ali➊an➊si
alias	ali➊as
aliran	alir➊an
alternatif	al➊ter➊na➊tif
ambang	am➊bang
ambil	am➊bil
amnesti	am➊nes➊ti
anaknya	anak➊nya
analis	ana➊lis
analisa	ana➊li➊sa
ancaman	acam➊an
Anda	An➊da
anggaran	ang➊gar➊an
anggota	ang➊go➊ta
anggotanya	ang➋go➋ta➊nya
angka	ang➊ka
angkasa	ang➊ka➊sa
angkatan	ang➊kat➊an
antar	an➊tar
antara	an➊ta➊ra
antaranya	an➋ta➋ra➊nya
antariksa	an➊ta➊rik➊sa
anti	an➊ti
apabila	apa➊bi➊la
apakah	apa➊kah
apalagi	apa➊la➊gi
apapun	apa➊pun
aparat	apa➊rat
April	Ap➊ril
arti	ar➊ti
artinya	arti➊nya
asasi	asa➊si
asli	as➊li
aspek	as➊pek
asuransi	asu➊ran➊si
ataupun	atau➊pun
atlet	at➊let
atomnya	atom➊nya
aturan	atur➊an
awalnya	awal➊nya
ayahnya	ayah➊nya
babak	ba➊bak
babi	ba➊bi
badai	ba➊dai
badan	ba➊dan
bagaimana	ba➊gai➊ma➊na
bagi	ba➊gi
bagian	ba➋gi➊an
baginya	ba➋gi➊nya
bagus	ba➊gus
bahan	ba➊han
bahasa	ba➊ha➊sa
bahaya	ba➊ha➊ya
bahkan	bah➊kan
bahwa	bah➊wa
baik	ba➊ik
baja	ba➊ja
baju	ba➊ju
bakal	ba➊kal
bakar	ba➊kar
bakteri	bak➊te➊ri
baku	ba➊ku
balapan	ba➋lap➊an
balas	ba➊las
balasan	ba➋las➊an
balik	ba➊lik
bandar	ban➊dar
bandara	ban➊da➊ra
banding	ban➊ding
bangga	bang➊ga
bangkit	bang➊kit
bangsa	bang➊sa
bangunan	bang➋un➊an
banjir	ban➊jir
bantuan	ban➋tu➊an
banyak	ba➊nyak
banyaknya	ba➋nyak➊nya
barang	ba➊rang
barat	ba➊rat
barisan	ba➋ris➊an
baru	ba➊ru
basis	ba➊sis
batas	ba➊tas
batu	ba➊tu
bawah	ba➊wah
bayi	ba➊yi
beban	be➊ban
bebas	be➊bas
beberapa	be➊be➊ra➊pa
beda	be➊da
begitu	be➊gi➊tu
bekas	be➊kas
bekerja	be➊ker➋ja
belah	be➊lah
belajar	be➊la➊jar
belakang	be➊la➊kang
belakangan	be➋la➋kang➊an
belanja	be➊lan➊ja
belasan	be➋las➊an
belum	be➊lum
benar	be➊nar
bencana	ben➊ca➊na
benda	ben➊da
bendera	ben➊de➊ra
bentrokan	ben➋trok➊an
bentuk	ben➊tuk
benua	be➊nua
berada	ber➊ada
beragam	be➊ra➋gam
beragama	ber➊aga➋ma
berakhir	ber➊akhir
berakhirnya	ber➊akhir➊nya
berangkat	be➊rang➊kat
berani	be➊ra➊ni
berapa	be➊ra➊pa
berarti	ber➊ar➋ti
beras	be➊ras
berasal	ber➊asal
berat	be➊rat
berbagai	ber➊ba➋gai
berbagi	ber➊ba➋gi
berbahasa	ber➊ba➋ha➋sa
berbahaya	ber➊ba➋ha➋ya
berbasis	ber➊ba➋sis
berbeda	ber➊be➋da
berbicara	ber➊bi➋ca➋ra
berbuat	ber➊buat
berbulan	ber➊bu➋lan
bercerita	ber➊ce➋ri➋ta
berdampak	ber➊dam➋pak
berdarah	ber➊da➋rah
berdasarkan	ber➊da➋sar➊kan
berdemonstrasi	ber➊de➋mon➋stra➋si
berdiri	ber➊di➋ri
bereaksi	be➊re➋ak➋si
beredar	ber➊edar
berencana	be➊ren➋ca➋na
berfungsi	ber➊fung➋si
bergabung	ber➊ga➋bung
bergantung	ber➊gan➋tung
bergerak	ber➊ge➋rak
berhadapan	ber➊ha➋dap➊an
berhak	ber➊hak
berhaluan	ber➊ha➋lu➊an
berharap	ber➊ha➋rap
berhasil	ber➊ha➋sil
berhenti	ber➊hen➋ti
berhubungan	ber➊hu➋bung➊an
berikut	ber➊ikut
berikutnya	ber➋ikut➊nya
berisi	ber➊isi
berita	be➊ri➊ta
berjalan	ber➊ja➋lan
berjanji	ber➊jan➋ji
berjuang	ber➊ju➋ang
berjudul	ber➊ju➋dul
berjumlah	ber➊jum➋lah
berkaitan	ber➊kait➊an
berkat	ber➊kat
berkembang	ber➊kem➋bang
berkomentar	ber➊ko➋men➋tar
berkuasa	ber➊kua➋sa
berkumpul	ber➊kum➋pul
berkunjung	ber➊kun➋jung
berkurang	ber➊ku➋rang
berlaku	ber➊la➋ku
berlangsung	ber➊lang➋sung
berlanjut	ber➊lan➋jut
berlebihan	ber➊le➋bih➊an
bermain	ber➊main
bermaksud	ber➊mak➋sud
bernama	ber➊na➋ma
berniat	ber➊niat
bernilai	ber➊ni➋lai
beroperasi	ber➊ope➋ra➋si
berpartisipasi	ber➊par➋ti➋si➋pa➋si
berpendapat	ber➊pen➊da➋pat
berpenduduk	ber➊pen➊du➋duk
berpengaruh	ber➊pen➋ga➋ruh
berperan	ber➊pe➋ran
berperang	ber➊pe➋rang
berpikir	ber➊pi➋kir
bersaing	ber➊saing
bersalah	ber➊sa➋lah
bersama	ber➊sa➋ma
bersamaan	ber➊sa➋ma➊an
bersangkutan	ber➊sang➋kut➊an
bersatu	ber➊sa➋tu
bersedia	ber➊se➋dia
bersejarah	ber➊se➋ja➋rah
bersembunyi	ber➊sem➋bu➋nyi
bersenjata	ber➊sen➋ja➋ta
bersiap	ber➊siap
bersifat	ber➊si➋fat
bersih	ber➊sih
bersikap	ber➊si➋kap
bersikeras	ber➊si➊ke➊ras
bertahan	ber➊ta➋han
bertahun	ber➊ta➋hun
bertambah	ber➊tam➋bah
bertanggung	ber➊tang➋gung
bertanya	ber➊tan➋ya
bertekad	ber➊te➋kad
bertemu	ber➊temu
bertentangan	ber➊ten➋tang➊an
bertikai	ber➊ti➋kai
bertindak	ber➊tin➋dak
bertolak	ber➊to➋lak
bertugas	ber➊tu➋gas
bertujuan	ber➊tu➋ju➊an
berubah	ber➊ubah
berulang	ber➊ul➋ang
berumur	ber➊u➋mur
berunding	be➊run➋ding
berupa	be➊ru➋pa
berupaya	ber➊upa➋ya
berusaha	ber➊usa➋ha
berusia	ber➊u➋sia
berwarna	ber➊war➋na
berwenang	ber➊we➋nang
besar	be➊sar
besaran	be➋sar➊an
besarnya	be➋sar➊nya
besi	be➊si
betapa	be➊ta➊pa
betul	be➊tul
biasa	bi➊a➊sa
biasanya	bi➋a➋sa➊nya
biaya	bi➊a➊ya
bicara	bi➊ca➊ra
bidang	bi➊dang
biksu	bik➊su
bila	bi➊la
bilang	bi➊lang
bilateral	bi➊la➊te➊ral
binatang	bi➊na➊tang
bintang	bin➊tang
biru	bi➊ru
bisa	bi➊sa
bisnis	bis➊nis
bius	bi➊us
blokade	blo➊ka➊de
bola	bo➊la
boleh	bo➊leh
brutal	bru➊tal
buah	bu➊ah
buat	bu➊at
buatan	bu➋at➊an
budaya	bu➊da➊ya
budiman	bu➊di➊man
bukan	bu➊kan
bukanlah	bukan➊lah
bukti	buk➊ti
buku	bu➊ku
bulan	bu➊lan
bumi	bu➊mi
bunga	bu➊nga
bunuh	bu➊nuh
bursa	bur➊sa
buruh	bu➊ruh
buruk	bu➊ruk
burung	bu➊rung
butuh	bu➊tuh
cabang	ca➊bang
cadangan	cadang➊an
cahaya	ca➊ha➊ya
calon	ca➊lon
campur	cam➊pur
cara	ca➊ra
catatan	ca➋tat➊an
cedera	ce➊de➊ra
cemas	ce➊mas
cenderung	cen➊de➊rung
cepat	ce➊pat
cerita	ce➊ri➊ta
champions	cham➊pi➊ons
cinta	cin➊ta
cita	ci➊ta
citra	ci➊tra
city	ci➊ty
coba	co➊ba
contoh	con➊toh
cuaca	cu➊a➊ca
cukup	cu➊kup
cuma	cu➊ma
daerah	da➊e➊rah
daftar	daf➊tar
dagang	da➊gang
daging	da➊ging
dahulu	da➊hu➊lu
dakwaan	da➋kwa➊an
dalam	da➊lam
dalamnya	da➋lam➊nya
damai	da➊mai
dampak	dam➊pak
dampaknya	dam➋pak➊nya
dana	da➊na
dapat	da➊pat
darah	da➊rah
darat	da➊rat
dari	da➊ri
daripada	da➊ri➊pa➊da
darurat	da➊ru➊rat
dasar	da➊sar
dasarnya	da➋sar➊nya
data	da➊ta
datang	da➊tang
daya	da➊ya
debat	de➊bat
defisit	de➊fi➊sit
dekade	de➊ka➊de
dekat	de➊kat
deklarasi	de➊kla➊ra➊si
delapan	de➊la➊pan
delegasi	de➊le➊ga➊si
demi	de➊mi
demikian	de➊mi➊ki➊an
demokrasi	de➊mo➊kra➊si
demokrat	de➊mo➊krat
demokratis	de➊mo➊kra➊tis
demonstran	de➊mon➊stran
demonstrasi	de➊mon➊stra➊si
dendam	den➊dam
dengan	de➊ngan
depan	de➊pan
departemen	de➊par➊te➊men
derajat	de➊ra➊jat
desa	de➊sa
desakan	de➋sak➊an
Desember	De➊sem➊ber
detik	de➊tik
dewan	de➊wan
dewasa	de➊wa➊sa
diadakan	di➊a➋da➊kan
diadili	di➊a➋di➋li
diajukan	di➊a➋ju➊kan
diakui	di➊a➋kui
dialami	di➊a➋la➋mi
dialog	di➊a➊log
diam	di➊am
diambil	di➊am➋bil
dianggap	di➊ang➋gap
diangkat	di➊ang➋kat
diantara	di➊an➋ta➋ra
diantaranya	di➊an➋ta➋ra➊nya
dibahas	di➊ba➋has
dibanding	di➊ban➋ding
dibandingkan	di➊ban➋ding➊kan
dibangun	di➊bangun
dibawa	di➊ba➋wa
dibayar	di➊ba➋yar
dibebaskan	di➊be➋bas➊kan
dibentuk	di➊ben➋tuk
diberi	di➊be➋ri
diberikan	di➊be➋ri➊kan
diberitakan	di➊be➋ri➋ta➊kan
diberlakukan	di➊ber➊la➋ku➊kan
dibicarakan	di➊bi➋ca➋ra➊kan
dibuat	di➊bu➋at
dibuka	di➊bu➋ka
dibunuh	di➊bu➋nuh
dibutuhkan	di➊bu➋tuh➊kan
dicapai	di➊ca➋pai
diculik	di➊cu➋lik
didirikan	di➊di➋ri➊kan
diduga	di➊du➋ga
didukung	di➊du➋kung
digelar	di➊ge➋lar
digital	di➊gi➊tal
digunakan	di➊gu➋na➊kan
dihadapi	di➊ha➋da➋pi
dihadiri	di➊ha➋di➋ri
diharapkan	di➊ha➋rap➊kan
dihentikan	di➊hen➋ti➊kan
dihukum	di➊hu➋kum
diikuti	di➊i➋ku➋ti
diinginkan	di➊ingin➊kan
dijadikan	di➊ja➋di➊kan
dijadwalkan	di➊jad➋wal➊kan
dijaga	di➊ja➋ga
dijalankan	di➊ja➋lan➊kan
dijatuhi	di➊ja➋tu➋hi
dijatuhkan	di➊ja➋tuh➊kan
dijelaskan	di➊je➋las➊kan
dijual	di➊ju➋al
dikabarkan	di➊ka➋bar➊kan
dikatakan	di➊ka➋ta➊kan
dikatakannya	di➊ka➋ta➊kan➊nya
dikeluarkan	di➊ke➋lu➋ar➊kan
dikembangkan	di➊kem➋bang➊kan
dikenal	di➊ke➋nal
dikerahkan	di➊ke➋rah➊kan
diketahui	di➊ke➋ta➋hui
dikhawatirkan	di➊kha➋wa➋tir➊kan
dikirim	di➊ki➋rim
dikritik	di➊kri➋tik
diktator	dik➊ta➊tor
dikuasai	di➊kua➋sai
dikutip	di➊ku➋tip
dilaksanakan	di➊lak➋sa➋na➊kan
dilakukan	di➊la➋ku➋kan
dilakukannya	di➊la➋ku➊kan➊nya
dilancarkan	di➊lan➋car➊kan
dilanda	di➊lan➋da
dilanjutkan	di➊lan➋jut➊kan
dilaporkan	di➊la➋por➊kan
dilarang	di➊la➋rang
dilengkapi	di➊leng➋ka➋pi
dilihat	di➊li➋hat
dilindungi	di➊lin➋dungi
dilontarkan	di➊lon➋tar➊kan
diluncurkan	di➊lun➋cur➊kan
dimaksud	di➊mak➋sud
dimana	di➊ma➋na
dimanfaatkan	di➊man➋faat➊kan
dimiliki	di➊mi➋li➋ki
diminta	di➊min➋ta
dimulai	di➊mu➋lai
dimulainya	di➊mu➋lai➊nya
dinas	di➊nas
dingin	di➊ngin
dini	di➊ni
dinilai	di➊ni➋lai
dinyatakan	di➊nya➋ta➊kan
dipakai	di➊pa➋kai
dipaksa	di➊pak➋sa
dipandang	di➊pan➋dang
dipastikan	di➊pas➋ti➊kan
dipenjara	di➊pen➋ja➋ra
dipenuhi	di➊pe➋nu➋hi
dipercaya	di➊per➋ca➋ya
diperiksa	di➊pe➋rik➋sa
diperkirakan	di➊per➊ki➋ra➊kan
diperlukan	di➊per➋lu➊kan
diperoleh	di➊per➊oleh
dipicu	di➊pi➋cu
dipilih	di➊pi➋lih
dipimpin	di➊pim➋pin
diplomasi	di➊plo➊ma➊si
diplomat	di➊plo➊mat
diplomatik	di➊plo➊ma➊tik
diproduksi	di➊pro➋duk➋si
dipublikasikan	di➊pu➋bli➋ka➋si➊kan
diputuskan	di➊pu➋tus➊kan
dirasakan	di➊ra➋sa➊kan
direktur	di➊rek➊tur
direncanakan	di➊ren➋ca➋na➊kan
diri	di➊ri
dirinya	di➋ri➊nya
disambut	di➊sam➋but
disampaikan	di➊sam➋pai➊kan
disana	di➊sa➋na
disebabkan	di➊se➋bab➊kan
disebut	di➊se➋but
disebutkan	di➊se➋but➊kan
diselenggarakan	di➊se➋leng➋ga➋ra➊kan
diselesaikan	di➊se➋le➋sai➊kan
disepakati	di➊se➋pa➋ka➋ti
diserahkan	di➊se➋rah➊kan
diserang	di➊se➋rang
disetujui	di➊se➋tu➋jui
disini	di➊si➋ni
diskriminasi	dis➊kri➊mi➊na➊si
diskusi	dis➊ku➊si
distrik	dis➊trik
ditahan	di➊ta➋han
ditambah	di➊tam➋bah
ditandatangani	di➊tan➋da➊tan➋ga➋ni
ditangani	di➊tan➋ga➋ni
ditangkap	di➊tang➋kap
ditarik	di➊ta➋rik
ditawarkan	di➊ta➋war➊kan
ditembak	di➊tem➋bak
ditempatkan	di➊tem➋pat➊kan
ditemukan	di➊te➋mu➊kan
ditentukan	di➊ten➋tu➊kan
diterapkan	di➊te➋rap➊kan
diterima	di➊te➋ri➋ma
ditetapkan	di➊te➋tap➊kan
ditingkatkan	di➊ting➋kat➊kan
ditolak	di➊to➋lak
dituding	di➊tu➋ding
dituduh	di➊tu➋duh
ditugaskan	di➊tu➋gas➊kan
ditujukan	di➊tu➋ju➊kan
ditunda	di➊tun➋da
ditunjukkan	di➊tun➋juk➊kan
dituntut	di➊tun➋tut
diturunkan	di➊tu➋run➊kan
ditutup	di➊tu➋tup
diubah	di➊ubah
diumumkan	di➊umum➊kan
diungkapkan	di➊ung➋kap➊kan
divonis	di➊vo➋nis
diwarnai	di➊war➋nai
diyakini	di➊ya➋ki➋ni
dokter	dok➊ter
dokumen	do➊ku➊men
dolar	do➊lar
dollar	dol➊lar
domestik	do➊mes➊tik
donor	do➊nor
dramatis	dra➊ma➊tis
drastis	dras➊tis
duduk	du➊duk
dugaan	du➋ga➊an
dukungan	du➋kung➊an
dulu	du➊lu
dunia	du➊nia
duta	du➊ta
editor	edi➊tor
efektif	efek➊tif
ekonomi	eko➊no➊mi
eksekusi	ek➊se➊ku➊si
eksekutif	ek➊se➊ku➊tif
ekspor	eks➊por
ekstremis	eks➊tre➊mis
ekstrim	eks➊trim
ekstrimis	eks➊tri➊mis
elektronik	elek➊tro➊nik
elemen	ele➊men
emisi	emi➊si
empat	em➊pat
energi	ener➊gi
Eropa	Ero➊pa
eskalasi	es➊ka➊la➊si
etnis	et➊nis
euro	eu➊ro
evakuasi	eva➊ku➊a➊si
Facebook	Face➊book
fakta	fak➊ta
faktor	fak➊tor
fase	fa➊se
fasilitas	fa➊si➊li➊tas
favorit	fa➊vo➊rit
Februari	Feb➊ru➊a➊ri
federal	fe➊de➊ral
fenomena	fe➊no➊me➊na
festival	fes➊ti➊val
final	fi➊nal
finansial	fi➊nan➊si➊al
fokus	fo➊kus
forum	fo➊rum
foto	fo➊to
fraksi	frak➊si
fungsi	fung➊si
gabungan	gabung➊an
gading	ga➊ding
gadis	ga➊dis
gagal	ga➊gal
gagasan	ga➋gas➊an
gaji	ga➊ji
gambar	gam➊bar
gambaran	gam➋bar➊an
ganda	gan➊da
gangguan	gang➋gu➊an
ganti	gan➊ti
garis	ga➊ris
gawang	ga➊wang
gaya	ga➊ya
Gaza	Ga➊za
gedung	ge➊dung
gelap	ge➊lap
gelar	ge➊lar
gelombang	ge➊lom➊bang
gembira	gem➊bi➊ra
gempa	gem➊pa
gencatan	gen➋cat➊an
generasi	ge➊ner➊asi
gerak	ge➊rak
gerakan	ge➋rak➊an
gereja	ge➊re➊ja
global	glo➊bal
gubernur	gu➊ber➊nur
gugatan	gu➋gat➊an
Guido	Gui➊do
guna	gu➊na
gunung	gu➊nung
guru	gu➊ru
habis	ha➊bis
hadapan	ha➋dap➊an
hadiah	ha➊di➊ah
hadir	ha➊dir
hakim	ha➊kim
halaman	ha➊lam➊an
halnya	hal➊nya
haluan	ha➊lu➊an
hambatan	ham➋bat➊an
hampir	ham➊pir
hancur	han➊cur
hangat	ha➊ngat
hanya	ha➊nya
hanyalah	ha➋nya➊lah
harap	ha➊rap
harapan	ha➋rap➊an
harga	har➊ga
hari	ha➊ri
harian	ha➋ri➊an
harinya	ha➋ri➊nya
harus	ha➊rus
hasil	ha➊sil
hasilnya	ha➋sil➊nya
hati	ha➊ti
hebat	he➊bat
helikopter	he➊li➊kop➊ter
hendak	hen➊dak
heran	he➊ran
hewan	he➊wan
hidup	hi➊dup
hidupnya	hi➋dup➊nya
hijau	hi➊jau
hilang	hi➊lang
hingga	hing➊ga
hitam	hi➊tam
hotel	ho➊tel
hubungan	hu➋bung➊an
hujan	hu➊jan
hukum	hu➊kum
hukuman	hu➋kum➊an
human	hu➊man
hutan	hu➊tan
hutang	hu➊tang
ibaratnya	iba➋rat➊nya
identitas	iden➊ti➊tas
ideologi	ide➋o➊lo➊gi
Ikhwanul	Ik➊hwa➊nul
iklan	ik➊lan
iklim	ik➊lim
ilegal	ile➊gal
ilmiah	il➊mi➊ah
ilmu	il➊mu
ilmuwan	il➋mu➊wan
imigran	imi➊gran
imigrasi	imi➊gra➊si
impor	im➊por
indah	in➊dah
indeks	in➊deks
independen	in➊de➊pen➊den
indikasi	in➊di➊ka➊si
individu	in➊di➊vi➊du
industri	in➊dus➊tri
infeksi	in➊fek➊si
informasi	in➊for➊ma➊si
infrastruktur	in➊fra➊struk➊tur
inilah	ini➊lah
inisiatif	ini➊si➊a➊tif
insiden	in➊si➊den
instalasi	in➊sta➊la➊si
institusi	in➊sti➊tu➊si
institut	in➊sti➊tut
integrasi	in➊te➊gra➊si
intelijen	in➊te➊li➊jen
intensif	in➊ten➊sif
internal	in➊ter➊nal
internasional	in➋ter➊na➋si➋o➋nal
international	in➋ter➊na➋ti➋o➋nal
internet	in➋ter➊net
intervensi	in➋ter➊ven➋si
inti	in➊ti
investasi	in➊ves➊ta➊si
investigasi	in➊ves➊ti➊ga➊si
investor	in➊ves➊tor
islam	is➊lam
islamic	is➊la➊mic
islamis	is➊la➊mis
istana	is➊ta➊na
istilah	is➊ti➊lah
istimewa	is➊ti➊me➊wa
istri	is➊tri
istrinya	is➋tri➊nya
isyarat	is➋ya➊rat
itulah	itu➊lah
jabatan	ja➋bat➊an
jabatannya	ja➋bat➊an➊nya
jadi	ja➊di
jadwal	jad➊wal
jajak	ja➊jak
jajaran	ja➋jar➊an
jaksa	jak➊sa
jalan	ja➊lan
jalanan	ja➋lan➊an
jalannya	ja➋lan➊nya
jalur	ja➊lur
jaminan	ja➋min➊an
jangan	ja➊ngan
jangka	jang➊ka
janji	jan➊ji
jantung	jan➊tung
Januari	Ja➊nu➊a➊ri
jarak	ja➊rak
jarang	ja➊rang
jaringan	ja➋ring➊an
jasa	ja➊sa
jatuh	ja➊tuh
jatuhnya	ja➋tuh➊nya
jauh	ja➊uh
jawab	ja➊wab
jawaban	ja➋wab➊an
jejak	je➊jak
jejaring	je➊ja➊ring
jelas	je➊las
jembatan	jem➊bat➊an
jenazah	je➊na➊zah
jenderal	jen➊de➊ral
jendral	jen➊dral
jenis	je➊nis
jihadis	ji➊ha➊dis
jika	ji➊ka
jiwa	ji➊wa
juara	ju➊a➊ra
juga	ju➊ga
juli	ju➊li
jumat	jum➊at
jumlah	jum➊lah
jumlahnya	jum➋lah➊nya
jumpa	jum➊pa
Juni	Ju➊ni
junta	jun➊ta
jurnalis	jur➊na➊lis
juru	ju➊ru
jurusan	ju➋rus➊an
justru	jus➊tru
juta	ju➊ta
jutaan	ju➋ta➊an
kabar	ka➊bar
kabinet	ka➊bi➊net
kaca	ka➊ca
kadang	ka➊dang
kaki	ka➊ki
kalah	ka➊lah
kalangan	ka➋lang➊an
kalau	ka➊lau
kali	ka➊li
kalian	ka➊li➊an
kalimat	ka➊li➊mat
kalinya	kali➊nya
kamar	ka➊mar
kamera	ka➊me➊ra
kami	ka➊mi
Kamis	Ka➊mis
kampanye	kam➊pa➊nye
kampung	kam➊pung
kanan	ka➊nan
kandang	kan➊dang
kandidat	kan➊di➊dat
kanker	kan➊ker
kanselir	kan➊se➊lir
kantor	kan➊tor
kapal	ka➊pal
kapan	ka➊pan
kapasitas	ka➊pa➊si➊tas
kapten	kap➊ten
karbon	kar➊bon
karena	ka➊re➊na
karenanya	ka➋re➋na➊nya
karir	ka➊rir
kartu	kar➊tu
karya	kar➊ya
karyawan	kar➊ya➊wan
kasih	ka➊sih
kasus	ka➊sus
kata	ka➊ta
katakan	ka➋ta➊kan
katanya	ka➋ta➊nya
kategori	ka➊te➊go➊ri
katolik	ka➊to➊lik
kaum	ka➊um
kawasan	ka➊wa➊san
kaya	ka➊ya
kayu	ka➊yu
keadaan	ke➊ada➊an
keadilan	ke➊a➋dil➊an
keamanan	ke➊a➋man➊an
keanggotaan	ke➊ang➋go➋ta➊an
kebakaran	ke➊ba➋kar➊an
kebanyakan	ke➊ban➋yak➊an
kebebasan	ke➊be➋bas➊an
kebenaran	ke➊be➋nar➊an
kebencian	ke➊ben➋ci➊an
keberadaan	ke➊ber➊ada➊an
keberatan	ke➊be➋rat➊an
keberhasilan	ke➊ber➊ha➋sil➊an
kebijakan	ke➊bi➋jak➊an
kebudayaan	ke➊bu➋da➋ya➊an
kebutuhan	ke➊bu➋tuh➊an
kecaman	ke➋cam➊an
kecelakaan	ke➊ce➋la➋ka➊an
kecemasan	ke➊ce➋mas➊an
kecepatan	ke➊ce➋pat➊an
kecewa	ke➊ce➊wa
kecil	ke➊cil
kecuali	ke➊cu➊a➊li
kecurangan	ke➊cu➋rang➊an
kedatangan	ke➊da➋tang➊an
kedaulatan	ke➊dau➋lat➊an
kedua	ke➊dua
keduanya	ke➊dua➊nya
kedutaan	ke➊du➋ta➊an
keempat	ke➊em➋pat
kegagalan	ke➊ga➋gal➊an
kegiatan	ke➊giat➊an
kehadiran	ke➊ha➋dir➊an
kehidupan	ke➊hi➋dup➊an
kehilangan	ke➊hi➋lang➊an
kehormatan	ke➊hor➋mat➊an
keinginan	ke➊ingin➊an
kejadian	ke➊ja➋di➊an
kejahatan	ke➊ja➋hat➊an
kejaksaan	ke➊jak➋sa➊an
kejutan	ke➋jut➊an
kekacauan	ke➊ka➋cau➊an
kekalahan	ke➊ka➋lah➊an
kekayaan	ke➊ka➋ya➊an
kekerasan	ke➊ke➋ras➊an
kekhawatiran	ke➊kha➋wa➋tir➊an
kekuasaan	ke➊kua➋sa➊an
kekuatan	ke➊kuat➊an
kekurangan	ke➊ku➋rang➊an
kelahiran	ke➊la➋hir➊an
kelanjutan	ke➊lan➋jut➊an
kelaparan	ke➊la➋par➊an
kelas	ke➊las
kelihatannya	ke➊li➋hat➊an➊nya
kelima	ke➊li➋ma
kelompok	ke➊lom➊pok
keluar	ke➊luar
keluarga	ke➊lu➊ar➊ga
keluarganya	ke➋luar➋ga➊nya
kemajuan	ke➊ma➋ju➊an
kemampuan	ke➊mam➋pu➊an
kemanusiaan	ke➊ma➋nu➋sia➊an
kemarahan	ke➊ma➋rah➊an
kemarin	ke➊ma➊rin
kematian	ke➊ma➋ti➊an
kembali	kem➊ba➊li
kemenangan	ke➊me➋nang➊an
kementerian	ke➊men➋te➋ri➊an
kementrian	ke➊men➋tri➊an
kemerdekaan	ke➊mer➋de➋ka➊an
kemiskinan	ke➊mis➋kin➊an
kemitraan	ke➊mi➋tra➊an
kemudian	ke➊mu➊di➊an
kemungkinan	ke➊mung➋kin➊an
kenaikan	ke➊naik➊an
kenal	ke➊nal
kenapa	ke➊na➊pa
kendali	ken➊da➋li
kendaraan	ken➋da➋ra➊an
kendati	ken➊da➊ti
kenyataan	ke➊nya➋ta➊an
kenyataannya	ke➊nya➋ta➊an➊nya
kepada	ke➊pa➊da
kepala	ke➊pa➊la
kepemimpinan	ke➊pe➊mim➊pin➊an
kepentingan	ke➊pen➋ting➊an
kepercayaan	ke➊per➋ca➋ya➊an
kepolisian	ke➊po➋li➋si➊an
kepresidenan	ke➊pre➋si➋den➊an
kepulauan	ke➊pu➋lau➊an
keputusan	ke➊pu➋tus➊an
keraguan	ke➊ra➋gu➊an
kerajaan	ke➊ra➋ja➊an
kerangka	ke➊rang➊ka
kerap	ke➊rap
keras	ke➊ras
kereta	ke➊re➊ta
kerja	ker➊ja
kertas	ker➊tas
kerugian	ke➊rugi➊an
kerusakan	ke➊ru➋sak➊an
kerusuhan	ke➊ru➋suh➊an
kesadaran	ke➊sa➋dar➊an
kesalahan	ke➊sa➋lah➊an
kesan	ke➊san
kesatuan	ke➊sa➋tu➊an
kesediaan	ke➊se➋dia➊an
kesehatan	ke➊se➋hat➊an
kesejahteraan	ke➊se➋jah➋te➋ra➊an
keselamatan	ke➊se➋la➋mat➊an
keseluruhan	ke➊se➋lu➋ruh➊an
kesempatan	ke➊sem➋pat➊an
kesepakatan	ke➊se➋pa➋kat➊an
kesimpulan	ke➊sim➋pul➊an
kesuksesan	ke➊suk➋ses➊an
kesulitan	ke➊su➋lit➊an
ketakutan	ke➊ta➋kut➊an
ketat	ke➊tat
ketegangan	ke➊te➋gang➊an
keterangan	ke➊te➋rang➊an
keterlibatan	ke➊ter➊li➋bat➊an
ketiga	ke➊ti➋ga
ketika	ke➊ti➋ka
ketimbang	ke➊tim➊bang
ketua	ke➊tua
keturunan	ke➊tu➋run➊an
keuangan	ke➊uang➊an
keuntungan	ke➊un➋tung➊an
kewajiban	ke➊wa➋jib➊an
khawatir	kha➊wa➊tir
khusus	khu➊sus
khususnya	khu➋sus➊nya
kilometer	ki➋lo➊me➋ter
kimia	ki➊mia
kini	ki➊ni
kira	ki➊ra
kiri	ki➊ri
kisah	ki➊sah
kita	ki➊ta
klasemen	kla➊se➊men
koalisi	ko➊a➊li➊si
komandan	ko➊man➊dan
komando	ko➊man➊do
komentar	ko➊men➊tar
komisaris	ko➊mi➊sa➊ris
komisi	ko➊mi➊si
komite	ko➊mi➊te
komitmen	ko➊mit➊men
kompetisi	kom➊pe➊ti➊si
kompleks	kom➊pleks
kompromi	kom➊pro➊mi
komputer	kom➊pu➊ter
komunikasi	ko➊mu➊ni➊ka➊si
komunis	ko➊mu➊nis
komunitas	ko➊mu➊ni➊tas
kondisi	kon➊di➊si
konferensi	kon➊fe➊ren➊si
konflik	kon➊flik
kongres	kong➊res
konkrit	kon➊krit
konsekuensi	kon➊se➊ku➊en➊si
konsep	kon➊sep
konser	kon➊ser
konservatif	kon➊ser➊va➊tif
konstitusi	kon➊sti➊tu➊si
konsultasi	kon➊sul➊ta➊si
konsumen	kon➊su➊men
konsumsi	kon➊sum➊si
kontak	kon➊tak
kontrak	kon➊trak
kontribusi	kon➋tri➊bu➋si
kontroversi	kon➋tro➊ver➋si
kontroversial	kon➋tro➊ver➋si➋al
konvensi	kon➊ven➊si
konvoi	kon➊voi
koordinasi	ko➊or➊di➊na➊si
koran	ko➊ran
korban	kor➊ban
korupsi	ko➊rup➊si
kosong	ko➊song
kota	ko➊ta
kotak	ko➊tak
kredit	kre➊dit
kriminal	kri➊mi➊nal
krisis	kri➊sis
Kristen	Kris➊ten
kritik	kri➊tik
kritis	kri➊tis
kualitas	ku➊a➊li➊tas
kuat	ku➊at
kubu	ku➊bu
kudeta	ku➊de➊ta
kuliah	ku➊li➊ah
kulit	ku➊lit
kunci	kun➊ci
kuning	ku➊ning
kunjungan	kun➋jung➊an
kunjungannya	kun➋jung➊an➊nya
kurang	ku➊rang
kurangnya	ku➋rang➊nya
kursi	kur➊si
kurun	ku➊run
laboratorium	la➊bo➊ra➊to➊ri➊um
laga	la➊ga
lagi	la➊gi
lagu	la➊gu
lahan	lah➊an
lahir	la➊hir
lain	la➊in
lainnya	la➋in➊nya
laki	la➊ki
lakukan	la➊ku➊kan
lalu	la➊lu
lama	la➊ma
lamanya	la➋ma➊nya
lambat	lam➊bat
lampu	lam➊pu
landasan	lan➋das➊an
langit	la➊ngit
langka	lang➊ka
langkah	lang➊kah
langsung	lang➊sung
lanjut	lan➊jut
lanjutan	lan➋jut➊an
lantaran	lan➋tar➊an
lapangan	la➋pang➊an
lapisan	la➋pis➊an
laporan	la➋por➊an
larangan	la➋rang➊an
latar	la➊tar
latihan	la➋tih➊an
latin	la➊tin
laut	la➊ut
lawan	la➊wan
lawatan	la➋wat➊an
layak	la➊yak
layanan	la➋yan➊an
layar	la➊yar
lebih	le➊bih
ledakan	le➋dak➊an
lega	le➊ga
Legowo	Le➊go➊wo
lelaki	le➊la➊ki
lemah	le➊mah
lembaga	lem➊ba➊ga
lengkap	leng➊kap
lepas	le➊pas
lewat	le➊wat
liar	li➊ar
liberal	li➊be➊ral
liga	li➊ga
lihat	li➊hat
lima	li➊ma
lingkungan	ling➋kung➊an
lintas	lin➊tas
lipat	li➊pat
listrik	lis➊trik
logistik	lo➊gis➊tik
lokal	lo➊kal
lokasi	lo➊ka➊si
lolos	lo➊los
luar	lu➊ar
luas	lu➊as
lubang	lu➊bang
luka	lu➊ka
lukisan	lu➊kis➊an
maaf	ma➊af
mahal	ma➊hal
mahasiswa	ma➊ha➊sis➊wa
mahkamah	mah➊ka➊mah
majalah	ma➊ja➊lah
majelis	ma➊je➊lis
maju	ma➊ju
maka	ma➊ka
makan	ma➊kan
makanan	ma➋kan➊an
makin	ma➊kin
maksimal	mak➊si➊mal
malah	ma➊lah
malam	ma➊lam
malaria	ma➊la➊ria
mampu	mam➊pu
mana	ma➊na
manajemen	ma➊na➊je➊men
manajer	ma➊na➊jer
mandat	man➊dat
manipulasi	ma➊ni➊pu➊la➊si
mantan	man➊tan
manusia	ma➊nu➊sia
marah	ma➊rah
maret	ma➊ret
marinir	ma➊ri➊nir
markas	mar➊kas
masa	ma➊sa
masalah	ma➊sa➊lah
masalahnya	ma➋sa➋lah➊nya
masih	ma➊sih
masing	ma➊sing
maskapai	mas➊ka➊pai
massa	mas➊sa
massal	mas➊sal
masuk	ma➊suk
masyarakat	ma➊sya➊ra➊kat
mata	ma➊ta
matahari	ma➋ta➊ha➋ri
materi	ma➊te➊ri
mati	ma➊ti
maupun	mau➊pun
mayat	ma➊yat
mayoritas	ma➊yo➊ri➊tas
medan	me➊dan
media	me➊dia
medis	me➊dis
meja	me➊ja
mekanisme	me➊ka➊nis➊me
melainkan	me➊lain➊kan
melaksanakan	me➊lak➋sa➋na➊kan
melakukan	me➊la➋ku➊kan
melakukannya	me➊la➋ku➊kan➊nya
melalui	me➊la➋lui
melancarkan	me➊lan➋car➊kan
melanda	me➊lan➋da
melanggar	me➊lang➋gar
melanjutkan	me➊lan➋jut➊kan
melaporkan	me➊la➋por➊kan
melarang	me➊la➋rang
melarikan	me➊la➋ri➊kan
melawan	me➊la➋wan
meledak	me➊le➋dak
melepaskan	me➊le➋pas➊kan
meletakkan	me➊le➋tak➊kan
melewati	me➊le➋wa➋ti
melibatkan	me➊li➋bat➊kan
melihat	me➊li➋hat
melindungi	me➊lin➋dun➋gi
meliputi	me➊li➋pu➋ti
melontarkan	me➊lon➋tar➊kan
meluas	me➊lu➋as
melukai	me➊lu➋kai
meluncurkan	me➊lun➋cur➊kan
memadai	me➊ma➊dai
memahami	me➊ma➊ha➋mi
memainkan	me➊main➊kan
memakai	me➊ma➊kai
memakan	me➊ma➋kan
memaksa	me➊mak➋sa
memandang	me➊man➊dang
memanfaatkan	me➊man➋faat➊kan
memang	me➊mang
memaparkan	me➊ma➊par➊kan
memasang	me➊ma➊sang
memastikan	me➊mas➊ti➊kan
memasuki	me➊ma➋su➋ki
mematikan	me➊ma➋ti➊kan
membaca	mem➊ba➋ca
membahas	mem➊ba➋has
membahayakan	mem➊ba➋ha➋ya➊kan
membaik	mem➊baik
membakar	mem➊ba➋kar
membangun	mem➊ban➋gun
membantah	mem➊ban➋tah
membantu	mem➊ban➋tu
membatalkan	mem➊ba➋tal➊kan
membatasi	mem➊ba➋ta➋si
membawa	mem➊ba➋wa
membayar	mem➊ba➋yar
membebaskan	mem➊be➋bas➊kan
membela	mem➊be➋la
membeli	mem➊be➋li
membenarkan	mem➊be➋nar➊kan
membentuk	mem➊ben➋tuk
memberi	mem➊be➋ri
memberikan	mem➊be➋ri➊kan
memberitakan	mem➊be➋ri➋ta➊kan
memberlakukan	mem➊ber➊la➋ku➊kan
membiarkan	mem➊bi➋ar➊kan
membicarakan	mem➊bi➋ca➋ra➊kan
memblokir	mem➊blo➋kir
membuahkan	mem➊buah➊kan
membuat	mem➊buat
membubarkan	mem➊bu➋bar➊kan
membuka	mem➊buka
membuktikan	mem➊bu➋kti➊kan
membunuh	mem➊bu➋nuh
memburuk	mem➊bu➋ruk
membutuhkan	mem➊bu➋tuh➊kan
memecahkan	me➊me➊cah➊kan
memegang	me➊me➊gang
memenangkan	me➊me➋nang➊kan
memenuhi	me➊me➊nu➋hi
memerangi	me➊me➊ra➋ngi
memeriksa	me➊me➊rik➊sa
memerintah	me➊me➊rin➊tah
memerintahkan	me➊me➊rin➊tah➊kan
memerlukan	me➊mer➊lu➊kan
memicu	me➊mi➊cu
memikirkan	me➊mi➊kir➊kan
memilih	me➊mi➊lih
memiliki	me➊mi➋li➋ki
memimpin	me➊mim➊pin
meminta	me➊min➋ta
mempengaruhi	mem➊pe➊nga➊ruhi
memperbaiki	mem➊per➊bai➋ki
memperhatikan	mem➊per➊ha➋ti➊kan
memperingatkan	mem➊per➊ingat➊kan
memperjuangkan	mem➊per➊ju➋ang➊kan
memperkirakan	mem➊per➊ki➋ra➊kan
memperkuat	mem➊per➊kuat
memperlihatkan	mem➊per➊li➋hat➊kan
memperluas	mem➊per➊luas
memperoleh	mem➊per➊oleh
memperpanjang	mem➊per➊pan➋jang
mempersiapkan	mem➊per➊siap➊kan
mempertahankan	mem➊per➊ta➊han➊kan
mempertanyakan	mem➊per➊ta➋nya➊kan
mempertimbangkan	mem➊per➊tim➊bang➊kan
memproduksi	mem➊pro➋duk➋si
memprotes	mem➊pro➋tes
mempunyai	mem➊pu➋nyai
memuji	me➊mu➊ji
memulai	me➊mu➋lai
memungkinkan	me➊mung➋kin➊kan
memutuskan	me➊mu➊tus➊kan
menahan	me➊na➊han
menaikkan	me➊naik➊kan
menambah	me➊nam➊bah
menambahkan	me➊nam➊bah➊kan
menampilkan	me➊nam➊pil➊kan
menampung	me➊nam➊pung
menandai	me➊nan➊dai
menandatangani	me➊nan➊da➊ta➊nga➋ni
menang	me➊nang
menangani	me➊na➊nga➋ni
menanggapi	me➊nang➊gapi
menangkap	me➊nang➊kap
menarik	me➊na➊rik
menawarkan	me➊na➊war➊kan
mencabut	men➊ca➋but
mencakup	men➊ca➋kup
mencalonkan	men➊ca➋lon➊kan
mencapai	men➊ca➋pai
mencari	men➊ca➋ri
mencatat	men➊ca➋tat
mencegah	men➊ce➋gah
menceritakan	men➊ce➋ri➋ta➊kan
mencetak	men➊ce➋tak
menciptakan	men➊cip➋ta➊kan
mencoba	men➊co➋ba
mendapat	men➊da➋pat
mendapatkan	men➊da➋pat➊kan
mendarat	men➊da➋rat
mendasar	men➊da➋sar
mendatang	men➊da➋tang
mendekati	men➊de➋ka➋ti
mendengar	men➊de➋ngar
mendengarkan	men➊de➋ngar➊kan
menderita	men➊de➋ri➋ta
mendesak	men➊de➋sak
mendirikan	men➊di➋ri➊kan
mendominasi	men➊do➋mi➋na➋si
mendorong	men➊do➋rong
menduduki	men➊du➋du➋ki
menduga	men➊du➋ga
mendukung	men➊du➋kung
menegaskan	me➊ne➊gas➊kan
menekan	me➊ne➊kan
menekankan	me➊ne➊kan➊kan
menelan	me➊ne➊lan
meneliti	me➊ne➊li➊ti
menembak	me➊nem➊bak
menempatkan	me➊nem➊pat➊kan
menempuh	me➊nem➊puh
menemui	me➊ne➊mui
menemukan	me➊ne➊mu➊kan
menengah	me➊ne➊ngah
menentang	me➊nen➊tang
menentukan	me➊nen➊tu➊kan
menerangkan	me➊ne➊rang➊kan
menerapkan	me➊ne➊rap➊kan
menerima	me➊ne➊ri➊ma
menerus	me➊ne➊rus
menetapkan	me➊ne➊tap➊kan
menewaskan	me➊ne➊was➊kan
mengabaikan	meng➊abai➊kan
mengadakan	meng➊ada➊kan
mengajak	meng➊ajak
mengajukan	meng➊aju➊kan
mengakhiri	meng➊akhi➋ri
mengakibatkan	meng➊aki➋bat➊kan
mengaku	meng➊aku
mengakui	meng➊akui
mengalahkan	me➊nga➊lah➊kan
mengalami	meng➊ala➋mi
mengalir	meng➊alir
mengamankan	meng➊aman➊kan
mengamati	meng➊ama➋ti
mengambil	meng➊am➋bil
mengancam	meng➊an➋cam
mengandalkan	meng➊an➋dal➊kan
mengandung	meng➊an➊dung
menganggap	meng➊ang➋gap
mengangkat	meng➊ang➋kat
mengangkut	meng➊ang➋kut
mengapa	meng➊apa
mengatakan	meng➊a➋ta➋kan
mengatasi	meng➊a➋ta➋si
mengatur	meng➊a➋tur
mengawasi	meng➊a➋wa➋si
mengecam	me➊nge➊cam
mengejar	me➊nge➊jar
mengejutkan	me➊nge➊jut➊kan
mengeluarkan	me➊nge➊lu➊ar➊kan
mengembalikan	me➊ngem➊ba➊li➊kan
mengembangkan	me➊ngem➊bang➊kan
mengemukakan	me➊nge➊mu➊ka➊kan
mengenai	me➊nge➊nai
mengenakan	me➊nge➊na➊kan
mengenal	me➊nge➊nal
mengerahkan	me➊nge➊rah➊kan
mengerikan	me➊nge➋ri➊kan
mengerti	meng➊erti
mengetahui	me➊nge➊ta➊hui
menggambarkan	meng➊gam➋bar➊kan
mengganggu	meng➊gang➋gu
menggantikan	meng➊gan➋ti➊kan
menggelar	meng➊ge➋lar
menggunakan	meng➊gu➋na➊kan
mengguncang	meng➊gun➋cang
menghabiskan	meng➊ha➋bis➊kan
menghadapi	meng➊ha➋da➋pi
menghadiri	meng➊ha➋di➋ri
menghalangi	meng➊ha➋lan➋gi
menghambat	meng➊ham➋bat
menghancurkan	meng➊han➋cur➊kan
menghapus	meng➊ha➋pus
mengharapkan	meng➊ha➋rap➊kan
menghasilkan	meng➊ha➋sil➊kan
menghentikan	meng➊hen➋ti➊kan
menghilang	meng➊hi➋lang
menghindari	meng➊hin➋da➋ri
menghormati	meng➊hor➋ma➋ti
mengijinkan	meng➊ijin➊kan
mengikat	meng➊ikat
mengikuti	meng➊iku➋ti
mengimbau	meng➊im➋bau
mengingat	meng➊ingat
mengingatkan	meng➊ingat➊kan
menginginkan	meng➊ingin➊kan
mengirim	me➊ngi➊rim
mengirimkan	me➊ngi➊rim➊kan
mengisi	meng➊isi
mengizinkan	meng➊izin➊kan
mengkhawatirkan	meng➊kha➋wa➋tir➊kan
mengklaim	meng➊klaim
mengkritik	meng➊kri➋tik
mengritik	me➊ngri➊tik
menguasai	me➊ngu➊a➊sai
mengubah	meng➊ubah
mengumpulkan	me➊ngum➊pul➊kan
mengumumkan	meng➊umum➊kan
mengundang	meng➊un➋dang
mengundurkan	meng➊un➋dur➊kan
mengungkap	meng➊ung➋kap
mengungkapkan	meng➊ung➋kap➊kan
mengungsi	meng➊ung➋si
mengunjungi	me➊ngun➊jungi
menguntungkan	meng➊un➋tung➊kan
mengupayakan	meng➊upa➋ya➊kan
mengurangi	me➊ngu➊rangi
mengusulkan	meng➊usul➊kan
mengutarakan	meng➊uta➋ra➊kan
mengutip	me➊ngu➊tip
menikmati	me➊nik➋ma➋ti
menilai	me➊ni➋lai
menimbulkan	me➊nim➊bul➊kan
meninggal	me➊ning➊gal
meninggalkan	me➊ning➊gal➊kan
meningkat	me➊ning➊kat
meningkatkan	me➊ning➊kat➊kan
meningkatnya	me➊ning➊kat➊nya
menit	me➊nit
menjabat	men➊ja➋bat
menjadi	men➊ja➋di
menjadikan	men➊ja➋di➊kan
menjaga	men➊ja➋ga
menjalani	men➊ja➋la➋ni
menjalankan	men➊ja➋lan➊kan
menjalin	men➊ja➋lin
menjamin	men➊ja➋min
menjanjikan	men➊jan➋ji➊kan
menjatuhkan	men➊ja➋tuh➊kan
menjawab	men➊ja➋wab
menjelang	men➊je➋lang
menjelaskan	men➊je➋las➊kan
menjual	men➊jual
menolak	me➊no➊lak
menolong	me➊no➊long
mentah	men➊tah
menteri	men➊te➊ri
menuding	me➊nu➊ding
menuduh	me➊nu➊duh
menuju	me➊nu➊ju
menulis	me➊nu➊lis
menunda	me➊nun➊da
menunggu	me➊nung➊gu
menunjuk	me➊nun➊juk
menunjukkan	me➊nun➊juk➊kan
menuntut	me➊nun➊tut
menurun	me➊nu➊run
menurunkan	me➊nu➊run➊kan
menurut	me➊nu➊rut
menurutnya	me➊nu➊rut➊nya
menutup	me➊nu➊tup
menutupi	me➊nu➊tupi
menuturkan	me➊nu➊tur➊kan
menyadari	me➊nya➊dari
menyaksikan	me➊nyak➊si➊kan
menyalahkan	me➊nya➊lah➊kan
menyambut	me➊nyam➊but
menyampaikan	me➊nyam➊pai➊kan
menyangkut	me➊nyang➊kut
menyatakan	me➊nya➊ta➊kan
menyebabkan	me➊nye➊bab➊kan
menyebar	me➊nye➊bar
menyebut	me➊nye➊but
menyebutkan	me➊nye➊but➊kan
menyebutnya	me➊nye➊but➊nya
menyediakan	me➊nye➊di➊a➊kan
menyelamatkan	me➊nye➊la➊mat➊kan
menyelesaikan	me➊nye➊le➊sai➊kan
menyelidiki	me➊nye➊li➊di➋ki
menyeluruh	me➊nye➊lu➊ruh
menyepakati	me➊nye➊pa➊ka➋ti
menyerah	me➊nye➊rah
menyerahkan	me➊nye➊rah➊kan
menyerang	me➊nye➊rang
menyerbu	me➊nyer➊bu
menyerukan	me➊nye➊ru➊kan
menyetujui	me➊nye➊tu➊jui
menyiapkan	me➊nyi➊ap➊kan
menyimpan	me➊nyim➊pan
menyimpulkan	me➊nyim➊pul➊kan
menyinggung	me➊nying➊gung
menyulut	me➊nyu➊lut
menyusul	me➊nyu➊sul
meragukan	me➊ra➊gu➊kan
merah	me➊rah
meraih	me➊raih
merasa	me➊rasa
merasakan	me➊ra➋sa➊kan
merayakan	me➊ra➋ya➊kan
merdeka	mer➊de➊ka
merebut	me➊re➋but
meredam	me➊re➋dam
mereka	me➊re➊ka
merencanakan	me➊ren➋ca➋na➊kan
merugikan	me➊ru➋gi➊kan
merujuk	me➊ru➋juk
merupakan	me➊ru➋pa➊kan
merusak	me➊ru➋sak
mesin	me➊sin
mesjid	mes➊jid
meski	mes➊ki
meskipun	mes➋ki➊pun
meter	me➊ter
metode	me➊to➊de
mewah	me➊wah
mewakili	me➊wa➋ki➋li
mewujudkan	me➊wu➋jud➊kan
meyakini	me➊ya➋ki➋ni
meyakinkan	me➊ya➋kin➊kan
migran	mi➊gran
migrasi	mi➊gra➊si
miliar	mi➊li➊ar
milik	mi➊lik
milisi	mi➊li➊si
militan	mi➊li➊tan
militer	mi➊li➊ter
militernya	mi➋li➋ter➊nya
milyar	mil➊yar
minggu	ming➊gu
minoritas	mi➊no➊ri➊tas
minta	min➊ta
minum	mi➊num
minyak	mi➊nyak
mirip	mi➊rip
misalnya	mi➋sal➊nya
misi	mi➊si
miskin	mis➊kin
mitra	mit➊ra
mobil	mo➊bil
modal	mo➊dal
model	mo➊del
moderat	mo➊de➊rat
modern	mo➊dern
mogok	mo➊gok
moneter	mo➊ne➊ter
moral	mo➊ral
motor	mo➊tor
Mubarak	Mu➊ba➊rak
muda	mu➊da
mudah	mu➊dah
muka	mu➊ka
mula	mu➊la
mulai	mu➊lai
muncul	mun➊cul
munculnya	mun➋cul➊nya
mundur	mun➊dur
mungkin	mung➊kin
murah	mu➊rah
murid	mu➊rid
Mursi	Mur➊si
museum	mu➊se➊um
musik	mu➊sik
musim	mu➊sim
muslim	mus➊lim
muslimin	mus➊li➊min
musuh	mu➊suh
mutlak	mut➊lak
nada	na➊da
naik	na➊ik
nama	na➊ma
namanya	na➋ma➊nya
nampaknya	nam➋pak➊nya
namun	na➊mun
nanti	nan➊ti
nantinya	nan➋ti➊nya
narkoba	nar➊ko➊ba
nasib	na➊sib
nasional	na➊si➊o➊nal
nasionalis	na➊si➊o➊na➊lis
natal	na➊tal
negara	ne➊ga➊ra
negaranya	ne➋ga➋ra➊nya
negatif	ne➊ga➊tif
negeri	ne➊ge➊ri
negerinya	ne➋ge➋ri➊nya
negosiasi	ne➊go➊si➊a➊si
nelayan	ne➊la➊yan
neraca	ne➊ra➊ca
niat	ni➊at
nilai	ni➊lai
nomor	no➊mor
normal	nor➊mal
November	No➊vem➊ber
nuklir	nuk➊lir
nuklirnya	nuk➋lir➊nya
nyaris	nya➊ris
nyata	nya➊ta
nyawa	nya➊wa
obatan	obat➊an
Oktober	Ok➊to➊ber
olahraga	olah➊ra➊ga
olimpiade	olim➊pi➊a➊de
online	on➊line
operasi	ope➊ra➊si
opini	opi➊ni
oposisi	opo➊si➊si
optimis	op➊ti➊mis
organisasi	or➊ga➊ni➊sa➊si
otomatis	oto➊ma➊tis
otomotif	oto➊mo➊tif
otonomi	oto➊no➊mi
otoritas	oto➊ri➊tas
pabrik	pa➊brik
pada	pa➊da
padahal	pa➊da➊hal
pagi	pa➊gi
pajak	pa➊jak
pakaian	pa➋kai➊an
pakar	pa➊kar
paket	pa➊ket
paksa	pak➊sa
palang	pa➊lang
paling	pa➊ling
palsu	pal➊su
pameran	pa➋me➊ran
panas	pa➊nas
pandang	pan➊dang
pandangan	pan➋dang➊an
pangan	pa➊ngan
panggung	pang➊gung
pangkalan	pang➋kal➊an
panglima	pang➊li➊ma
panjang	pan➊jang
panser	pan➊ser
pantai	pan➊tai
papan	pa➊pan
para	pa➊ra
parah	pa➊rah
pariwisata	pa➊ri➊wi➊sa➊ta
parlemen	par➊le➊men
partai	par➊tai
partainya	par➋tai➊nya
partisipasi	par➊ti➊si➊pa➊si
pasal	pa➊sal
pasalnya	pa➋sal➊nya
pasangan	pa➋sang➊an
pasar	pa➊sar
pasaran	pa➋sar➊an
pasca	pas➊ca
pasien	pa➊si➊en
pasokan	pa➋sok➊an
paspor	pas➊por
pasti	pas➊ti
pasukan	pa➋suk➊an
pasukannya	pa➋suk➊an➊nya
patroli	pat➊ro➊li
paus	pa➊us
pecah	pe➊cah
pedagang	pe➊da➋gang
peduli	pe➊du➊li
pegawai	pe➊ga➋wai
pegunungan	pe➊gu➋nung➊an
pejabat	pe➊ja➋bat
pejuang	pe➊juang
pekan	pe➊kan
pekerja	pe➊ker➋ja
pekerjaan	pe➊ker➋ja➊an
pelabuhan	pe➊la➋buh➊an
pelajaran	pe➊la➊jar➊an
pelaksanaan	pe➊lak➋sa➋na➊an
pelaku	pe➊la➋ku
pelakunya	pe➊la➋ku➊nya
pelanggan	pe➊lang➋gan
pelanggaran	pe➊lang➋gar➊an
pelatih	pe➊la➋tih
pelatihan	pe➊la➋tih➊an
pelayanan	pe➊la➋yan➊an
pelecehan	pe➊le➋ceh➊an
peledak	pe➊le➋dak
pelindung	pe➊lin➋dung
peluang	pe➊luang
peluncuran	pe➊lun➋cur➊an
peluru	pe➊lu➊ru
pemain	pe➊main
pemanasan	pe➊ma➊nas➊an
pemantau	pe➊man➊tau
pembagian	pem➊ba➋gi➊an
pembakaran	pem➊ba➋kar➊an
pembalap	pem➊ba➋lap
pembangkit	pem➊bang➋kit
pembangunan	pem➊bangun➊an
pembantaian	pem➊ban➋tai➊an
pembantu	pem➊ban➋tu
pembatasan	pem➊ba➋tas➊an
pembayaran	pem➊ba➋yar➊an
pembebasan	pem➊be➋bas➊an
pembela	pem➊be➋la
pembentukan	pem➊ben➋tuk➊an
pemberantasan	pem➊be➋ran➋tas➊an
pemberian	pem➊be➋ri➊an
pemberitaan	pem➊be➋ri➋ta➊an
pemberontak	pem➊be➋ron➋tak
pemberontakan	pem➊be➋ron➋tak➊an
pembicaraan	pem➊bi➋ca➋ra➊an
pemboman	pem➊bom➊an
pembukaan	pem➊bu➋ka➊an
pembunuh	pem➊bu➋nuh
pembunuhan	pem➊bu➋nuh➊an
pemenang	pe➊me➋nang
pemeriksaan	pe➊me➊rik➊sa➊an
pemerintah	pe➊me➊rin➊tah
pemerintahan	pe➊me➊rin➊tah➊an
pemerintahannya	pe➊me➊rin➊tah➊an➊nya
pemerkosaan	pe➊mer➊ko➊sa➊an
pemilih	pe➊mi➊lih
pemilihan	pe➊mi➊lih➊an
pemilik	pe➊mi➋lik
pemimpin	pe➊mim➊pin
pemuda	pe➊mu➋da
pemukiman	pe➊mu➋kim➊an
pemungutan	pe➊mu➊ngut➊an
penahanan	pe➊na➊han➊an
penambahan	pe➊nam➊bah➊an
penampilan	pe➊nam➊pil➊an
penampungan	pe➊nam➊pung➊an
penanganan	pe➊na➊ngan➊an
penanggulangan	pe➊nang➊gu➊lang➊an
penangkapan	pe➊nang➊kap➊an
penarikan	pe➊na➊rik➊an
penasehat	pe➊na➋se➋hat
pencari	pen➊ca➋ri
pencarian	pen➊ca➋ri➊an
pencegahan	pen➊ce➋gah➊an
pencemaran	pen➊ce➋mar➊an
penculikan	pen➊cu➋lik➊an
pendahulunya	pen➊da➋hu➋lu➊nya
pendapat	pen➊da➋pat
pendapatan	pen➊da➋pat➊an
pendatang	pen➊da➋tang
pendek	pen➊dek
pendekatan	pen➊de➋kat➊an
penderita	pen➊de➋ri➋ta
penderitaan	pen➊de➋ri➋ta➊an
pendidikan	pen➊di➋dik➊an
pendiri	pen➊di➋ri
penduduk	pen➊du➋duk
pendudukan	pen➊du➋duk➊an
penduduknya	pen➊du➋duk➊nya
pendukung	pen➊du➋kung
pendukungnya	pen➊du➋kung➊nya
peneliti	pe➊ne➊li➊ti
penelitian	pe➊ne➊li➊ti➊an
penembakan	pe➊nem➊bak➊an
penempatan	pe➊nem➊pat➊an
penemuan	pe➊ne➊mu➊an
penentang	pe➊nen➊tang
penerbangan	pe➊ner➊bang➊an
penerima	pe➊ne➊ri➊ma
pengacara	peng➊aca➋ra
pengadilan	peng➊adil➊an
pengakuan	peng➊aku➊an
pengalaman	peng➊alam➊an
pengamanan	peng➊aman➊an
pengamat	peng➊amat
pengangguran	peng➊ang➋gur➊an
pengaruh	pe➊nga➊ruh
pengasingan	peng➊asing➊an
pengawas	peng➊awas
pengawasan	peng➊awas➊an
pengayaan	pe➊nga➊ya➊an
pengembangan	pe➊ngem➊bang➊an
pengetahuan	pe➊nge➊ta➋hu➊an
pengganti	peng➊gan➋ti
pengguna	peng➊gu➋na
penggunaan	peng➊gu➋na➊an
penghargaan	peng➊har➋ga➊an
penghematan	peng➊he➋mat➊an
penghentian	peng➊hen➋ti➊an
penghitungan	peng➊hi➋tung➊an
pengikut	peng➊ikut
pengiriman	pe➊ngi➊rim➊an
pengobatan	peng➊obat➊an
penguasa	pe➊ngu➊a➊sa
pengumuman	peng➊umum➊an
pengunduran	peng➊un➋dur➊an
pengungsi	peng➊ung➋si
pengunjuk	peng➊un➋juk
pengunjung	pe➊ngun➊jung
pengurangan	pe➊ngu➊rang➊an
pengusaha	peng➊usa➋ha
penilaian	pe➊ni➋lai➊an
peningkatan	pe➊ning➊kat➊an
penjaga	pen➊jaga
penjagaan	pen➊ja➋ga➊an
penjahat	pen➊ja➋hat
penjara	pen➊ja➊ra
penjelasan	pen➊je➋las➊an
penjualan	pen➊jual➊an
penjuru	pen➊ju➋ru
penolakan	pe➊no➊lak➊an
penonton	pe➊non➊ton
pensiun	pen➊si➊un
penting	pen➊ting
pentingnya	pen➋ting➊nya
penugasan	pe➊nu➊gas➊an
penuh	pe➊nuh
penulis	pe➊nu➊lis
penumpang	pe➊num➊pang
penuntut	pe➊nun➊tut
penurunan	pe➊nu➊run➊an
penutupan	pe➊nu➊tup➊an
penyadapan	pe➊nya➊dap➊an
penyakit	pe➊nya➊kit
penyebab	pe➊nye➊bab
penyebaran	pe➊nye➊bar➊an
penyelamat	pe➊nye➊la➊mat
penyelamatan	pe➊nye➊la➊mat➊an
penyelenggara	pe➊nye➊leng➊ga➊ra
penyelesaian	pe➊nye➊le➊sai➊an
penyelidikan	pe➊nye➊li➊dik➊an
penyerang	pe➊nye➊rang
penyidik	pe➊nyi➊dik
penyidikan	pe➊nyi➊dik➊an
penyiksaan	pe➊nyik➊sa➊an
perahu	pe➊ra➊hu
perairan	per➊air➊an
peralatan	per➊alat➊an
peran	pe➊ran
peranan	pe➋ran➊an
perang	pe➊rang
perangkat	pe➊rang➊kat
perasaan	pe➊ra➋sa➊an
peraturan	per➊atur➊an
perawatan	pe➊ra➋wat➊an
perayaan	pe➊ra➋ya➊an
perbaikan	per➊baik➊an
perbankan	per➊bank➊an
perbatasan	per➊ba➋tas➊an
perbedaan	per➊be➋da➊an
percakapan	per➊ca➋kap➊an
percaya	per➊ca➊ya
percobaan	per➊co➋ba➊an
perdagangan	per➊da➋gang➊an
perdamaian	per➊da➋mai➊an
perdana	per➊da➊na
perdebatan	per➊de➋bat➊an
perekonomian	per➊eko➋no➋mi➋an
perempuan	pe➊rem➊pu➊an
pergantian	per➊gan➋ti➊an
pergi	per➊gi
perhatian	per➊ha➋ti➊an
perhimpunan	per➊him➋pun➊an
perhitungan	per➊hi➋tung➊an
peringatan	per➊ingat➊an
peringkat	pe➊ring➊kat
perintah	pe➊rin➊tah
periode	pe➊ri➊o➊de
peristiwa	pe➊ris➊ti➊wa
perjalanan	per➊ja➋lan➊an
perjanjian	per➊jan➋ji➊an
perjuangan	per➊juang➊an
perkara	per➊ka➊ra
perkembangan	per➊kem➋bang➊an
perkiraan	per➊ki➋ra➊an
perlawanan	per➊la➋wan➊an
perlindungan	per➊lin➋dung➊an
perlu	per➊lu
perluasan	per➊luas➊an
permainan	per➊main➊an
permasalahan	per➊ma➋sa➋lah➊an
permintaan	per➊min➋ta➊an
permohonan	per➊mo➋hon➊an
permukaan	per➊mu➋ka➊an
pernah	per➊nah
pernikahan	per➊ni➋kah➊an
pernyataan	per➊nya➋ta➊an
pernyataannya	per➊nya➋ta➊an➊nya
perolehan	per➊oleh➊an
perpanjangan	per➊pan➋jang➊an
perpecahan	per➊pe➋cah➊an
persahabatan	per➊sa➋ha➋bat➊an
persaingan	per➊saing➊an
persatuan	per➊sa➋tu➊an
persen	per➊sen
persenjataan	per➊sen➋ja➋ta➊an
perserikatan	per➊se➋ri➋kat➊an
persetujuan	per➊se➋tu➋ju➊an
persiapan	per➊siap➊an
persidangan	per➊si➋dang➊an
persoalan	per➊soal➊an
perspektif	per➊spek➊tif
persyaratan	per➊sya➋rat➊an
pertahanan	per➊ta➋han➊an
pertama	per➊ta➊ma
pertamanya	per➋ta➋ma➊nya
pertambangan	per➊tam➋bang➊an
pertanda	per➊tan➋da
pertandingan	per➊tan➋ding➊an
pertanian	per➊ta➋ni➊an
pertanyaan	per➊ta➋nya➊an
pertempuran	per➊tem➋pur➊an
pertemuan	per➊te➋mu➊an
pertengahan	per➊te➋ngah➊an
pertikaian	per➊ti➋kai➊an
pertukaran	per➊tu➋kar➊an
pertumbuhan	per➊tum➋buh➊an
perubahan	per➊ubah➊an
perumahan	pe➊ru➋mah➊an
perundingan	pe➊run➋ding➊an
perusahaan	per➊usa➋ha➊an
perwakilan	per➊wa➋kil➊an
perwira	per➊wi➊ra
pesan	pe➊san
pesat	pe➊sat
pesawat	pe➊sa➊wat
peserta	pe➊ser➊ta
pesisir	pe➊si➊sir
pesta	pes➊ta
peta	pe➊ta
petani	pe➊ta➋ni
petinggi	pe➊ting➋gi
petugas	pe➊tu➋gas
petunjuk	pe➊tun➋juk
piala	pi➊a➊la
pidana	pi➊da➊na
pidato	pi➊da➊to
pidatonya	pi➋da➋to➊nya
pihak	pi➊hak
pihaknya	pi➋hak➊nya
pikir	pi➊kir
pilihan	pi➋lih➊an
pilot	pi➊lot
pimpinan	pim➋pin➊an
pindah	pin➊dah
pinggiran	ping➋gir➊an
pinjaman	pin➋jam➊an
pintu	pin➊tu
pipa	pi➊pa
planet	pla➊net
plastik	plas➊tik
pohon	po➊hon
poin	po➊in
pokok	po➊kok
polisi	po➊li➊si
politik	po➊li➊tik
politiknya	po➋li➋tik➊nya
politis	po➊li➊tis
politisi	po➊li➊ti➊si
ponsel	pon➊sel
populasi	po➊pu➊la➊si
populer	po➊pu➊ler
posisi	po➊si➊si
posisinya	po➋si➋si➊nya
positif	po➊si➊tif
potensi	po➊ten➊si
prajurit	pra➊ju➊rit
praktek	prak➊tek
praktik	prak➊tik
presiden	pre➊si➊den
prestasi	pres➊ta➊si
pribadi	pri➊ba➊di
prinsip	prin➊sip
prioritas	pri➊o➊ri➊tas
produk	pro➊duk
produksi	pro➊duk➊si
produsen	pro➊du➊sen
profesional	pro➊fe➊si➊o➊nal
profesor	pro➊fe➊sor
program	pro➊gram
propaganda	pro➊pa➊gan➊da
prosedur	pro➊se➊dur
proses	pro➊ses
protes	pro➊tes
provinsi	pro➊vin➊si
provokasi	pro➊vo➊ka➊si
proyek	proy➊ek
puas	pu➊as
publik	pu➊blik
puing	pu➊ing
pukul	pu➊kul
pukulan	pu➋kul➊an
pula	pu➊la
pulang	pu➊lang
pulau	pu➊lau
puluh	pu➊luh
puluhan	pu➋luh➊an
puncak	pun➊cak
punya	pu➊nya
pusat	pu➊sat
putaran	pu➋tar➊an
putih	pu➊tih
putra	pu➊tra
putri	pu➊tri
putusan	pu➋tus➊an
rabu	ra➊bu
radiasi	ra➊di➊a➊si
radikal	ra➊di➊kal
radio	ra➊dio
ragu	ra➊gu
rahasia	ra➊ha➊sia
raja	ra➊ja
raksasa	rak➊sa➊sa
rakyat	rak➊yat
rakyatnya	rak➋yat➊nya
ramah	ra➊mah
ramai	ra➊mai
rancangan	ran➋cang➊an
rangka	rang➊ka
rangkaian	rang➋kai➊an
ranjau	ran➊jau
rapat	ra➊pat
rasa	ra➊sa
rasisme	ra➊sis➊me
rata	ra➊ta
ratusan	ra➋tus➊an
raya	ra➊ya
reaksi	re➊ak➊si
reaktor	re➊ak➊tor
real	re➊al
referendum	re➊fe➊ren➊dum
reformasi	re➊for➊ma➊si
regional	re➊gi➊o➊nal
rejim	re➊jim
rekaman	re➋kam➊an
rekan	re➊kan
rekannya	rekan➊nya
rekonsiliasi	re➊kon➊si➊li➊a➊si
rekor	re➊kor
relatif	re➊la➊tif
remaja	re➊ma➊ja
rencana	ren➊ca➊na
rencananya	ren➋ca➋na➊nya
rendah	ren➊dah
reporter	re➊por➊ter
republik	re➊pu➊blik
resesi	re➊se➊si
resiko	re➊si➊ko
resmi	res➊mi
resolusi	re➊so➊lu➊si
restoran	res➊to➊ran
revolusi	re➊vo➊lu➊si
rezim	re➊zim
ribu	ri➊bu
ribuan	ri➋bu➊an
Rice	Ri➊ce
ringan	ri➊ngan
riset	ri➊set
risiko	ri➊si➊ko
robot	ro➊bot
roket	ro➊ket
ruang	ru➊ang
ruangan	ruang➊an
rudal	ru➊dal
rugi	ru➊gi
rumah	ru➊mah
rumahnya	ru➋mah➊nya
rumit	ru➊mit
rupiah	ru➊pi➊ah
rusak	ru➊sak
rutin	ru➊tin
saat	sa➊at
saatnya	saat➊nya
Sabtu	Sab➊tu
sadar	sa➊dar
sahabat	sa➊ha➊bat
saham	sa➊ham
saja	sa➊ja
sakit	sa➊kit
saksi	sak➊si
salah	sa➊lah
saling	sa➊ling
saluran	sa➋lur➊an
sama	sa➊ma
sambil	sam➊bil
sampah	sam➊pah
sampai	sam➊pai
samping	sam➊ping
sana	sa➊na
sandera	san➊de➊ra
sangat	sa➊ngat
sanksi	sank➊si
sapi	sa➊pi
sarana	sa➊ra➊na
sasaran	sa➋sar➊an
satelit	sa➊te➊lit
satu	sa➊tu
satuan	sa➋tu➊an
satunya	sa➋tu➊nya
saudara	sau➊da➊ra
saya	sa➊ya
sayap	sa➊yap
seakan	se➊akan
sebab	se➊bab
sebagai	se➊ba➋gai
sebagaimana	se➊ba➋gai➋ma➋na
sebagian	se➊ba➋gi➊an
sebaiknya	se➊baik➋nya
sebaliknya	se➊ba➋lik➊nya
sebanyak	se➊ba➋nyak
sebelah	se➊be➋lah
sebelum	se➊be➋lum
sebelumnya	se➊be➋lum➊nya
sebenarnya	se➊be➋nar➊nya
seberapa	se➊be➋ra➋pa
sebesar	se➊be➋sar
sebetulnya	se➊be➋tul➊nya
sebuah	se➊buah
sebulan	se➊bu➋lan
sebut	se➊but
secara	se➊ca➊ra
secepatnya	se➊ce➋pat➊nya
sedang	se➊dang
sedangkan	se➋dang➊kan
sederhana	se➊der➊ha➊na
sedikit	se➊di➋kit
sedikitnya	se➊di➋kit➊nya
segala	se➊ga➊la
segalanya	se➋ga➋la➊nya
segera	se➊ge➊ra
segi	se➊gi
sehari	se➊ha➋ri
seharusnya	se➊ha➊rus➊nya
sehat	se➊hat
sehingga	se➊hing➋ga
sehubungan	se➊hu➋bung➊an
seiring	se➊iring
sejak	se➊jak
sejarah	se➊ja➊rah
sejauh	se➊jauh
sejumlah	se➊jum➋lah
sekali	se➊ka➋li
sekaligus	se➊ka➊li➊gus
sekalipun	se➊ka➊li➊pun
sekarang	se➊ka➊rang
sekedar	se➊ke➊dar
sekelompok	se➊ke➋lom➋pok
sekitar	se➊ki➊tar
sekitarnya	se➋ki➋tar➊nya
sekolah	se➊ko➊lah
sekretaris	sek➊re➊ta➊ris
seksual	sek➊su➊al
sektor	sek➊tor
sekutu	se➊ku➊tu
sela	se➊la
selain	se➊la➊in
selalu	se➊la➊lu
selama	se➊la➊ma
selamat	se➊la➊mat
selanjutnya	se➊lan➋jut➊nya
selasa	se➊la➊sa
selatan	se➊la➊tan
selesai	se➊le➊sai
seluruh	se➊lu➊ruh
seluruhnya	se➋lu➋ruh➊nya
semacam	se➊ma➋cam
semakin	se➊ma➋kin
semangat	se➊ma➊ngat
sembilan	sem➊bi➊lan
sementara	se➊men➊ta➊ra
semi	se➊mi
sempat	sem➊pat
semua	se➊mua
semuanya	se➋mua➊nya
semula	se➊mu➋la
senang	se➊nang
senat	se➊nat
senator	se➊na➊tor
sendiri	sen➊di➊ri
sendirian	sen➋di➋ri➊an
sengaja	se➊nga➊ja
sengit	se➊ngit
sengketa	seng➊ke➊ta
seni	se➊ni
senilai	se➊ni➋lai
seniman	se➊ni➊man
senin	se➊nin
senior	se➊ni➊or
senjata	sen➊ja➊ta
sensor	sen➊sor
sentral	sen➊tral
seolah	se➊olah
seorang	se➊orang
sepak	se➊pak
sepakat	se➊pa➊kat
sepanjang	se➊pan➋jang
separatis	se➊pa➊ra➊tis
separuh	se➊pa➋ruh
sepeda	se➊pe➊da
sepekan	se➊pe➋kan
sepenuhnya	se➊pe➋nuh➊nya
seperti	se➊per➊ti
sepertiga	se➊per➊ti➋ga
sepertinya	se➋per➋ti➊nya
September	Sep➊tem➊ber
sepuluh	se➊pu➋luh
seputar	se➊pu➋tar
serangan	se➋rang➊an
serangkaian	se➊rang➋kai➊an
serdadu	ser➊da➊du
serikat	se➊ri➊kat
sering	se➊ring
seringkali	se➊ring➊ka➊li
serius	se➊ri➊us
serta	ser➊ta
seruan	se➋ru➊an
serupa	se➊ru➋pa
sesaat	se➊sa➋at
seseorang	se➊se➊orang
sesuai	se➊suai
sesuatu	se➊sua➋tu
sesudah	se➊su➋dah
sesungguhnya	se➊sung➋guh➊nya
setahun	se➊ta➋hun
setelah	se➊te➋lah
setempat	se➊tem➋pat
setengah	se➊te➋ngah
setia	se➊tia
setiap	se➊tiap
setidaknya	se➊ti➋dak➋nya
setuju	se➊tu➋ju
seumur	se➊umur
seusai	se➊usai
siang	si➊ang
siap	si➊ap
siapa	si➊a➊pa
siapapun	si➋a➋pa➊pun
siaran	si➊a➊ran
sibuk	si➊buk
sidang	si➊dang
sikap	si➊kap
silam	si➊lam
simbol	sim➊bol
simpati	sim➊pa➊ti
singkat	sing➊kat
sini	si➊ni
sinyal	si➊nyal
sipil	si➊pil
sisa	si➊sa
sisi	si➊si
sistem	sis➊tem
sistim	sis➊tim
situ	si➊tu
situasi	si➊tu➊a➊si
situasinya	si➋tu➋a➋si➊nya
situs	si➊tus
skala	ska➊la
skandal	skan➊dal
skeptis	skep➊tis
slogan	slo➊gan
smartphone	smart➊phone
solidaritas	so➊li➊da➊ri➊tas
solusi	so➊lu➊si
sore	so➊re
sorotan	so➋rot➊an
sosial	so➊si➊al
sosialis	so➊si➊a➊lis
sosok	so➊sok
spekulasi	spe➊ku➊la➊si
stabil	sta➊bil
stabilitas	sta➊bi➊li➊tas
stadion	sta➊di➊on
standar	stan➊dar
stasiun	sta➊si➊un
statistik	sta➊tis➊tik
status	sta➊tus
strategi	stra➊te➊gi
strategis	stra➊te➊gis
struktur	struk➊tur
studi	stu➊di
suaka	su➊a➊ka
suami	su➊a➊mi
suara	su➊a➊ra
suaranya	su➋a➋ra➊nya
suasana	su➊a➊sa➊na
suatu	su➊a➊tu
subsidi	sub➊si➊di
suci	su➊ci
sudah	su➊dah
sudut	su➊dut
suhu	su➊hu
suka	su➊ka
sukses	suk➊ses
suku	su➊ku
sulit	su➊lit
sumbangan	sum➋bang➊an
sumber	sum➊ber
sungai	su➊n➊➊gai
sungguh	sung➊guh
sunni	sun➊ni
supaya	su➊pa➊ya
super	su➊per
surat	su➊rat
surya	sur➊ya
susu	su➊su
sutradara	su➊tra➊da➊ra
swasta	swas➊ta
syarat	sya➊rat
syiah	syi➊ah
tadi	ta➊di
tadinya	ta➋di➊nya
tahanan	ta➋han➊an
tahap	ta➊hap
tahu	ta➊hu
tahun	ta➊hun
tahunan	ta➋hun➊an
tahunnya	ta➋hun➊nya
tajam	ta➊jam
tajuk	ta➊juk
taktik	tak➊tik
takut	ta➊kut
taman	ta➊man
tambah	tam➊bah
tambahan	tam➋bah➊an
tampak	tam➊pak
tampaknya	tam➋pak➊nya
tampil	tam➊pil
tamu	ta➊mu
tanah	ta➊nah
tanaman	ta➋nam➊an
tanda	tan➊da
tandas	tan➊das
tangan	ta➊ngan
tangga	tang➊ga
tanggal	tang➊gal
tanggung	tang➊gung
tanpa	tan➊pa
tantangan	tan➋tang➊an
tanya	tan➊ya
tapi	ta➊pi
target	tar➊get
tarik	ta➊rik
tata	ta➊ta
tawaran	ta➋war➊an
tegang	te➊gang
tegas	te➊gas
tekanan	te➋kan➊an
teknik	tek➊nik
teknis	tek➊nis
teknologi	tek➊no➊lo➊gi
telah	te➊lah
telefon	te➊le➊fon
telepon	te➊le➊pon
televisi	te➊le➊vi➊si
teluk	te➊luk
tema	te➊ma
teman	te➊man
tembak	tem➊bak
tembakan	tem➋bak➊an
tembok	tem➊bok
tempat	tem➊pat
tempur	tem➊pur
temuan	te➋mu➊an
tenaga	te➊na➊ga
tenang	te➊nang
tenda	ten➊da
tengah	te➊ngah
tenggara	teng➊ga➊ra
tenggelam	teng➊ge➊lam
tentang	ten➊tang
tentara	ten➊ta➊ra
tentu	ten➊tu
tentunya	ten➋tu➊nya
teori	te➊o➊ri
tepat	te➊pat
tepi	te➊pi
terakhir	ter➊ak➋hir
terancam	ter➊an➋cam
terang	te➊rang
terapi	te➊ra➊pi
terasa	te➊ra➋sa
terbaik	ter➊baik
terbang	ter➊bang
terbanyak	ter➊ba➋nyak
terbaru	ter➊ba➋ru
terbarukan	ter➊ba➋ru➊kan
terbatas	ter➊ba➋tas
terbentuk	ter➊ben➋tuk
terbesar	ter➊be➋sar
terbuka	ter➊bu➋ka
terbukti	ter➊buk➋ti
terbunuh	ter➊bu➋nuh
terburuk	ter➊bu➋ruk
tercantum	ter➊can➋tum
tercapai	ter➊ca➋pai
tercatat	ter➊ca➋tat
terdakwa	ter➊dak➋wa
terdapat	ter➊da➋pat
terdengar	ter➊de➋ngar
terdiri	ter➊di➋ri
tergabung	ter➊ga➋bung
tergantung	ter➊gan➋tung
tergolong	ter➊go➋long
terhadap	ter➊ha➋dap
terima	te➊ri➊ma
terjadi	ter➊jadi
terjadinya	ter➊ja➋di➊nya
terkait	ter➊kait
terkejut	ter➊ke➋jut
terkemuka	ter➊ke➊mu➋ka
terkena	ter➊ke➋na
terkenal	ter➊ke➋nal
terkuat	ter➊kuat
terlalu	ter➊la➊lu
terlebih	ter➊le➋bih
terlepas	ter➊le➋pas
terletak	ter➊le➋tak
terlibat	ter➊li➋bat
terlihat	ter➊li➋hat
terluka	ter➊lu➋ka
termasuk	ter➊ma➋suk
ternyata	ter➊nya➋ta
terobosan	te➊ro➊bos➊an
teror	te➊ror
teroris	te➊ro➊ris
terorisme	te➊ro➊ris➊me
terpaksa	ter➊pak➋sa
terpenting	ter➊pen➋ting
terpidana	ter➊pi➋da➋na
terpilih	ter➊pi➋lih
terpisah	ter➊pi➋sah
tersangka	ter➊sang➋ka
tersebar	ter➊se➋bar
tersebut	ter➊se➋but
tersedia	ter➊se➋dia
tersisa	ter➊si➋sa
tertarik	ter➊ta➋rik
tertentu	ter➊ten➋tu
tertinggi	ter➊ting➋gi
tertulis	ter➊tu➋lis
tertutup	ter➊tu➋tup
terungkap	ter➊ung➋kap
terus	te➊rus
terutama	ter➊uta➋ma
tetangga	te➊tang➊ga
tetangganya	te➋tang➋ga➊nya
tetap	te➊tap
tetapi	te➊ta➊pi
tewas	te➊was
tewasnya	te➋was➊nya
tiap	ti➊ap
tiba	ti➊ba
tidak	ti➊dak
tidaklah	ti➋dak➊lah
tidur	ti➊dur
tiga	ti➊ga
timnya	tim➊nya
timur	ti➊mur
tindak	tin➊dak
tindakan	tin➋dak➊an
tinggal	ting➊gal
tinggi	ting➊gi
tingginya	ting➋gi➊nya
tingkat	ting➊kat
tipis	ti➊pis
titik	ti➊tik
toko	to➊ko
tokoh	to➊koh
toleransi	to➊le➊ran➊si
topan	to➊pan
topik	to➊pik
total	to➊tal
tradisi	tra➊di➊si
tradisional	tra➊di➊si➊o➊nal
tragedi	tra➊ge➊di
transaksi	tran➊sak➊si
transfer	trans➊fer
transisi	tran➊si➊si
transparan	trans➊pa➊ran
transportasi	trans➊por➊ta➊si
tsunami	tsu➊na➊mi
tuan	tu➊an
tubuh	tu➊buh
tudingan	tu➋ding➊an
tuduhan	tu➋duh➊an
tugas	tu➊gas
tugasnya	tu➋gas➊nya
tujuan	tu➋ju➊an
tujuh	tu➊juh
tulis	tu➊lis
tumbuh	tum➊buh
tuntas	tun➊tas
tuntutan	tun➋tut➊an
turis	tu➊ris
turun	tu➊run
turut	tu➊rut
tutup	tu➊tup
tutur	tu➊tur
uang	ua➊ng
udara	uda➊ra
ujarnya	ujar➊nya
ulama	ula➊ma
umumnya	umum➊nya
undang	un➊dang
undangan	un➋dang➊an
unggul	ung➊gul
ungkap	ung➊kap
universitas	uni➊ver➊si➊tas
unjuk	un➊juk
unsur	un➊sur
untuk	un➊tuk
upacara	upa➊ca➊ra
upaya	upa➊ya
uranium	ura➊ni➊um
urusan	urus➊an
usaha	usa➊ha
usulan	usul➊an
utama	uta➊ma
utamanya	uta➋ma➊nya
utara	uta➊ra
utusan	utus➊an
vaksin	vak➊sin
versi	ver➊si
video	vi➊deo
vidi	vi➊di
virus	vi➊rus
visa	vi➊sa
vonis	vo➊nis
wabah	wa➊bah
wajah	wa➊jah
wajib	wa➊jib
wakil	wa➊kil
waktu	wak➊tu
waktunya	wak➋tu➊nya
walau	wa➊lau
walaupun	wa➋lau➊pun
wanita	wa➊ni➊ta
warga	war➊ga
warganya	war➋ga➊nya
warisan	wa➋ris➊an
warna	war➊na
wartawan	war➊ta➊wan
wawancara	wa➊wan➊ca➊ra
wilayah	wi➊la➊yah
wisata	wi➊sa➊ta
wisatawan	wi➊sa➊ta➊wan
Yahudi	Ya➊hu➊di
yaitu	ya➊i➊tu
yakin	ya➊kin
yakni	yak➊ni
yayasan	ya➊ya➊san
zaman	za➊man
zona	zo➊na
