Form	Hyphenation

# SPDX-License-Identifier: Unicode-DFS-2016

aan	aan
aanbeveling	aan➊be➊ve➊ling
aanbieden	aan➊bie➊den
aanbod	aan➊bod
aandacht	aan➊dacht
aandeel	aan➊deel
aandeelhouder	aan➋deel➊hou➋der
aandeelhouders	aan➋deel➊hou➋ders
aandeelhoudersvergadering	aan➋deel➊hou➋ders➊ver➋ga➋de➋ring
aandelen	aan➊de➊len
aandelenbeurzen	aan➋de➋len➊beur➋zen
aandelenmarkten	aan➋de➋len➊mark➋ten
aangeboden	aan➊ge➊bo➊den
aangegeven	aan➊ge➊ge➊ven
aangehouden	aan➊ge➊hou➊den
aangeklaagd	aan➊ge➊klaagd
aangekondigd	aan➊ge➊kon➊digd
aangekondigde	aan➊ge➊kon➊dig➊de
aangenomen	aan➊ge➊no➊men
aangepast	aan➊ge➊past
aangetroffen	aan➊ge➊trof➊fen
aangezien	aan➊ge➊zien
aangifte	aan➊gif➊te
aanhet	aan➊het
aanhoudende	aan➊hou➊den➊de
aankondiging	aan➊kon➊di➊ging
aankoop	aan➊koop
aanleiding	aan➊lei➊ding
aanloop	aan➊loop
aanpak	aan➊pak
aanslag	aan➊slag
aanslagen	aan➊sla➊gen
aanstaande	aan➊staan➊de
aantal	aan➊tal
aantrekkelijk	aan➊trek➊ke➊lijk
aanval	aan➊val
aanvankelijk	aan➊van➊ke➊lijk
aanvragen	aan➊vra➊gen
aanwezig	aan➊we➊zig
aanzienlijk	aan➊zien➊lijk
aarde	aar➊de
aardig	aar➊dig
Abn	Abn
ABN	ABN
absoluut	ab➊so➊luut
account	ac➊count
acht	acht
achter	ach➊ter
achtergrond	ach➋ter➊grond
acteur	ac➊teur
actie	ac➊tie
actief	ac➊tief
acties	ac➊ties
actieve	ac➊tie➊ve
activiteiten	ac➊ti➊vi➊tei➊ten
actrice	ac➊tri➊ce
actuele	ac➊tu➊e➊le
adres	adres
advies	ad➊vies
adviseur	ad➊vi➊seur
advocaat	ad➊vo➊caat
advocaten	ad➊vo➊ca➊ten
Aegon	Ae➊gon
AEGON	AE➊GON
Aex	Aex
AEX	AEX
afdeling	af➊de➊ling
affaire	af➊fai➊re
afgelopen	af➊ge➊lo➊pen
afgenomen	af➊ge➊no➊men
afgerond	af➊ge➊rond
afgesloten	af➊ge➊slo➊ten
afgesproken	af➊ge➊spro➊ken
afhankelijk	af➊han➊ke➊lijk
afkomstig	af➊kom➊stig
aflevering	af➊le➊ve➊ring
afloop	af➊loop
AFM	AFM
AFN	AFN
afname	af➊na➊me
afp	afp
AFP	AFP
afrika	afri➊ka
Afrika	Afri➊ka
Afrikaanse	Afri➊kaan➊se
afscheid	af➊scheid
afspraken	af➊spra➊ken
afstand	af➊stand
agenda	agen➊da
agent	agent
agenten	agen➊ten
Ahold	Ahold
AHOLD	AHOLD
air	air
Air	Air
Ajax	Ajax
akkoord	ak➊koord
AkzoNobel	Ak➋zo➊No➋bel
Albert	Al➊bert
album	al➊bum
alcohol	al➊co➊hol
aldus	al➊dus
Alex	Alex
Alexander	Alexan➊der
algemeen	al➊ge➊meen
algemene	al➊ge➊me➊ne
all	all
All	All
alle	al➊le
allebei	al➋le➊bei
alleen	al➊leen
allemaal	al➋le➊maal
allen	al➊len
allerlei	al➋ler➊lei
alles	al➊les
als	als
alsnog	als➊nog
alsof	als➊of
alternatief	al➊ter➊na➊tief
Altice	Al➊ti➊ce
altijd	al➊tijd
alvast	al➊vast
alweer	al➊weer
amber	am➊ber
Amber	Am➊ber
ambtenaren	amb➊te➊na➊ren
America	Ame➊ri➊ca
american	ame➊ri➊can
American	Ame➊ri➊can
amerika	ame➊ri➊ka
Amerika	Ame➊ri➊ka
amerikaanse	ame➊ri➊kaan➊se
Amerikaanse	Ame➊ri➊kaan➊se
Amerikanen	Ame➊ri➊ka➊nen
amp	amp
amro	am➊ro
Amro	Am➊ro
AMRO	AM➊RO
Amsterdam	Am➋ster➊dam
Amsterdamse	Am➋ster➊dam➊se
analist	ana➊list
analisten	ana➊lis➊ten
analyse	ana➊ly➊se
and	and
ander	an➊der
andere	an➊de➊re
anderen	an➊de➊ren
anderhalf	an➋der➊half
anders	an➊ders
André	An➊dré
ANDRÉ	AN➊DRÉ
Angela	An➊ge➊la
Angeles	An➊ge➊les
angst	angst
Anouk	An➊ouk
anp	anp
antwoord	ant➊woord
app	app
appartement	ap➊par➊te➊ment
apple	ap➊ple
Apple	Ap➊ple
Arabië	Ara➊bië
arbeidsmarkt	ar➋beids➊markt
Arcadis	Ar➊ca➊dis
ArcelorMittal	Ar➋cel➋or➊Mit➋tal
arm	arm
Arnhem	Arn➊hem
artiesten	ar➊ties➊ten
artikel	ar➊ti➊kel
artikelen	ar➊ti➊ke➊len
arts	arts
artsen	art➊sen
ASML	ASML
Assad	As➊sad
Asscher	As➊scher
augustus	au➊gus➊tus
Australië	Au➊stra➊lië
Australische	Au➊stra➊li➊sche
auto	au➊to
automatisch	au➊to➊ma➊tisch
autoriteit	au➊to➊ri➊teit
Autoriteit	Au➊to➊ri➊teit
autoriteiten	au➊to➊ri➊tei➊ten
avond	avond
awards	awards
Awards	Awards
Aziatische	Azi➊a➊ti➊sche
Azië	Azië
baan	baan
baas	baas
baby	ba➊by
bakker	bak➊ker
Bakker	Bak➊ker
balans	ba➊lans
ballast	bal➊last
Ballast	Bal➊last
bam	bam
Bam	Bam
BAM	BAM
band	band
banden	ban➊den
banen	ba➊nen
bang	bang
bank	bank
banken	ban➊ken
bankiers	ban➊kiers
Barack	Ba➊rack
basis	ba➊sis
BBC	BBC
bbp	bbp
beatrix	be➊a➊trix
Beatrix	Be➊a➊trix
Beckham	Beck➊ham
bed	bed
bedoeld	be➊doeld
bedoeling	be➊doe➊ling
bedraagt	be➊draagt
bedrag	be➊drag
bedragen	be➊dra➊gen
bedreigd	be➊dreigd
bedrijf	be➊drijf
bedrijfsleven	be➋drijfs➊le➋ven
bedrijfsresultaat	be➋drijfs➊re➋sul➋taat
bedrijven	be➊drij➊ven
bedrijvigheid	be➊drij➊vig➊heid
bedroeg	be➊droeg
beeld	beeld
beelden	beel➊den
been	been
beetje	beet➊je
begin	be➊gin
beginnen	be➊gin➊nen
begint	be➊gint
begon	be➊gon
begonnen	be➊gon➊nen
begroting	be➊gro➊ting
behaald	be➊haald
behaalde	be➊haal➊de
behalen	be➊ha➊len
behalve	be➊hal➊ve
Behalve	Be➊hal➊ve
behandeld	be➊han➊deld
behandeling	be➊han➊de➊ling
beheer	be➊heer
behoefte	be➊hoef➊te
behoorlijk	be➊hoor➊lijk
behoort	be➊hoort
behouden	be➊hou➊den
beide	bei➊de
beiden	bei➊den
bekeken	be➊ke➊ken
bekend	be➊kend
bekende	be➊ken➊de
bekendgemaakt	be➋kend➊ge➋maakt
bekijk	be➊kijk
bekijken	be➊kij➊ken
belang	be➊lang
belangen	be➊lan➊gen
belangrijk	be➋lang➊rijk
belangrijke	be➋lang➊rij➋ke
belangrijkste	be➋lang➊rijk➋ste
belangstelling	be➋lang➊stel➋ling
belasting	be➊las➊ting
belastingdienst	be➋las➋ting➊dienst
belastingen	be➊las➊tin➊gen
beleggen	be➊leg➊gen
belegger	be➊leg➊ger
beleggers	be➊leg➊gers
belegging	be➊leg➊ging
beleggingen	be➊leg➊gin➊gen
beleggingsadvies	be➋leg➋gings➊ad➋vies
beleid	be➊leid
België	Bel➊gië
Belgische	Bel➊gi➊sche
bellen	bel➊len
beloning	be➊lo➊ning
beloofde	be➊loof➊de
ben	ben
benadrukt	be➊na➊drukt
benadrukte	be➊na➊druk➊te
beneden	be➊ne➊den
bent	bent
bepaald	be➊paald
bepaalde	be➊paal➊de
bepalen	be➊pa➊len
beperken	be➊per➊ken
beperkt	be➊perkt
beperkte	be➊perk➊te
bereid	be➊reid
bereiken	be➊rei➊ken
bereikt	be➊reikt
bereikte	be➊reik➊te
bericht	be➊richt
berichten	be➊rich➊ten
Berlijn	Ber➊lijn
beroemde	be➊roem➊de
beroep	be➊roep
bescheiden	be➊schei➊den
beschermen	be➊scher➊men
bescherming	be➊scher➊ming
beschikbaar	be➊schik➊baar
beschuldigd	be➊schul➊digd
beschuldigingen	be➊schul➊di➊gin➊gen
beslag	be➊slag
beslissing	be➊slis➊sing
besloot	be➊sloot
besloten	be➊slo➊ten
besluit	be➊sluit
besluiten	be➊slui➊ten
besparen	be➊spa➊ren
best	best
bestaan	be➊staan
bestaande	be➊staan➊de
bestaat	be➊staat
beste	bes➊te
bestuur	be➊stuur
bestuurder	be➊stuur➊der
bestuurders	be➊stuur➊ders
bestuursvoorzitter	be➋stuurs➊voor➋zit➋ter
betaald	be➊taald
betaalde	be➊taal➊de
betaalt	be➊taalt
betalen	be➊ta➊len
betaling	be➊ta➊ling
betekenen	be➊te➊ke➊nen
betekent	be➊te➊kent
beter	be➊ter
betere	be➊te➊re
betreffende	be➊tref➊fen➊de
betreft	be➊treft
betrokken	be➊trok➊ken
betrokkenheid	be➊trok➊ken➊heid
beurs	beurs
beursgang	beurs➊gang
beursgenoteerde	beurs➊ge➋no➋teer➋de
beurshandel	beurs➊han➋del
beurt	beurt
beurzen	beur➊zen
bevallen	be➊val➊len
bevestigd	be➊ves➊tigd
bevestigde	be➊ves➊tig➊de
bevestigt	be➊ves➊tigt
bevolking	be➊vol➊king
beweert	be➊weert
bewegen	be➊we➊gen
beweging	be➊we➊ging
bewijs	be➊wijs
bewoners	be➊wo➊ners
bewust	be➊wust
Beyoncé	Be➊yon➊cé
bezig	be➊zig
bezit	be➊zit
bezittingen	be➊zit➊tin➊gen
bezocht	be➊zocht
bezoek	be➊zoek
bezoeken	be➊zoe➊ken
bezoekers	be➊zoe➊kers
bezorgd	be➊zorgd
bezuinigen	be➊zui➊ni➊gen
bezuinigingen	be➊zui➊ni➊gin➊gen
Bieber	Bie➊ber
bieden	bie➊den
biedt	biedt
bij	bij
bijdrage	bij➊dra➊ge
bijeenkomst	bij➊een➊komst
bijna	bij➊na
bijvoorbeeld	bij➊voor➊beeld
bijzonder	bij➊zon➊der
bijzondere	bij➊zon➊de➊re
bill	bill
Bill	Bill
binnen	bin➊nen
binnenkort	bin➋nen➊kort
binnenlandse	bin➋nen➊land➋se
Blackrock	Black➊rock
BlackRock	Black➊Rock
blad	blad
bleef	bleef
bleek	bleek
bleven	ble➊ven
blij	blij
blijft	blijft
blijkbaar	blijk➊baar
blijken	blij➊ken
blijkt	blijkt
blijven	blij➊ven
bloed	bloed
blok	blok
Blok	Blok
blondine	blon➊di➊ne
Bloomberg	Bloom➊berg
BMW	BMW
bnp	bnp
BNP	BNP
bob	bob
Bob	Bob
BOB	BOB
Bobbi	Bob➊bi
bod	bod
bodem	bo➊dem
boek	boek
boeken	boe➊ken
boekjaar	boek➊jaar
boekte	boek➊te
boer	boer
Boer	Boer
boete	boe➊te
boetes	boe➊tes
bond	bond
boodschap	bood➊schap
boom	boom
boord	boord
boos	boos
boot	boot
bos	bos
bosch	bosch
Bosch	Bosch
BOSCH	BOSCH
Boskalis	Bos➊ka➊lis
boten	bo➊ten
boulevard	bou➊le➊vard
bouw	bouw
bouwbedrijf	bouw➊be➋drijf
bouwen	bou➊wen
boven	bo➊ven
bovendien	bo➊ven➊dien
Bovendien	Bo➊ven➊dien
bovenop	bo➊ven➊op
Brabant	Bra➊bant
bracht	bracht
brak	brak
branchegenoot	bran➋che➊ge➋noot
brand	brand
brandweer	brand➊weer
Braziliaanse	Bra➊zi➊li➊aan➊se
Brazilië	Bra➊zi➊lië
Breda	Bre➊da
brede	bre➊de
breed	breed
brengen	bren➊gen
brengt	brengt
brent	brent
Brent	Brent
brentolie	brent➊olie
Brentolie	Brent➊olie
breuk	breuk
brexit	brexit
Brexit	Brexit
brief	brief
Britse	Brit➊se
Brittannië	Brit➊tan➊nië
Britten	Brit➊ten
broer	broer
bron	bron
bronnen	bron➊nen
Brown	Brown
brug	brug
bruiloft	brui➊loft
BrunoPress	Bru➋no➊Press
Brussel	Brus➊sel
bruto	bru➊to
btw	btw
buik	buik
buiten	bui➊ten
buitenland	bui➋ten➊land
buitenlandse	bui➋ten➊land➋se
bureau	bu➊reau
buren	bu➊ren
burgemeester	bur➋ge➊mees➋ter
burgers	bur➊gers
bus	bus
business	bu➊si➊ness
buurt	buurt
buy	buy
camera	ca➊me➊ra
Cameron	Ca➊me➊ron
campagne	cam➊pag➊ne
Canada	Ca➊na➊da
Canadese	Ca➊na➊de➊se
cao	cao
capital	ca➊pi➊tal
carrière	car➊ri➊è➊re
cash	cash
CBS	CBS
CDA	CDA
cel	cel
celstraf	cel➊straf
cent	cent
centraal	cen➊traal
Centraal	Cen➊traal
centrale	cen➊tra➊le
centrum	cen➊trum
Charles	Char➊les
Charlie	Char➊lie
chemische	che➊mi➊sche
China	Chi➊na
chinese	chi➊ne➊se
Chinese	Chi➊ne➊se
Chris	Chris
cijfer	cij➊fer
cijfers	cij➊fers
circa	cir➊ca
city	ci➊ty
club	club
coach	coach
coalitie	co➊a➊li➊tie
collega	col➊le➊ga
college	col➊le➊ge
column	co➊lumn
combinatie	com➊bi➊na➊tie
commentaar	com➊men➊taar
commissaris	com➊mis➊sa➊ris
commissarissen	com➊mis➊sa➊ris➊sen
commissie	com➊mis➊sie
compleet	com➊pleet
concept	con➊cept
concern	con➊cern
concert	con➊cert
conclusie	con➊clu➊sie
concrete	con➊cre➊te
concurrent	con➊cur➊rent
concurrenten	con➊cur➊ren➊ten
concurrentie	con➊cur➊ren➊tie
conflict	con➊flict
consument	con➊su➊ment
consumenten	con➊su➊men➊ten
consumentenvertrouwen	con➋su➋men➋ten➊ver➋trou➋wen
contact	con➊tact
contract	con➊tract
contracten	con➊trac➊ten
controle	con➊tro➊le
correctie	cor➊rec➊tie
Cosby	Cos➊by
crisis	cri➊sis
cultuur	cul➊tuur
Cyprus	Cy➊prus
daadwerkelijk	daad➊wer➋ke➋lijk
daalde	daal➊de
daalden	daal➊den
daalt	daalt
daar	daar
daarbij	daar➊bij
daardoor	daar➊door
daarentegen	daar➊en➊te➊gen
daarin	daar➊in
daarmee	daar➊mee
daarna	daar➊na
daarnaast	daar➊naast
daarom	daar➊om
daarop	daar➊op
daarover	daar➊over
daarvan	daar➊van
daarvoor	daar➊voor
dacht	dacht
dader	da➊der
daders	da➊ders
dag	dag
dagblad	dag➊blad
dagelijks	da➋ge➊lijks
dagen	da➊gen
daily	dai➊ly
dak	dak
dalen	da➊len
dalende	da➊len➊de
daling	da➊ling
dam	dam
Dam	Dam
dames	da➊mes
Damrak	Dam➊rak
dan	dan
danken	dan➊ken
dankzij	dank➊zij
dat	dat
data	da➊ta
datum	da➊tum
David	Da➊vid
DAX	DAX
deal	deal
debat	de➊bat
december	de➊cem➊ber
deden	de➊den
deed	deed
deel	deel
deelde	deel➊de
deelname	deel➊na➋me
deelnemers	deel➊ne➋mers
deels	deels
deelt	deelt
Deense	Deen➊se
defensie	de➊fen➊sie
definitief	de➊fi➊ni➊tief
definitieve	de➊fi➊ni➊tie➊ve
Dekker	Dek➊ker
delen	de➊len
delta	del➊ta
Delta	Del➊ta
den	den
Den	Den
denk	denk
denken	den➊ken
denkt	denkt
der	der
derde	der➊de
dergelijke	der➊ge➊lij➊ke
dertig	der➊tig
destijds	des➊tijds
details	de➊tails
deur	deur
deuren	deu➊ren
deutsche	deut➊sche
deze	de➊ze
dezelfde	de➊zelf➊de
DFT	DFT
dicht	dicht
dichtbij	dicht➊bij
die	die
diens	diens
dienst	dienst
diensten	dien➊sten
dienstensector	dien➋sten➊sec➋tor
dienstverlener	dienst➊ver➋le➋ner
dient	dient
diep	diep
dieptepunt	diep➊te➊punt
dier	dier
dieren	die➊ren
digitale	di➊gi➊ta➊le
Dijsselbloem	Dijs➋sel➊bloem
dik	dik
dikke	dik➊ke
dingen	din➊gen
dinsdag	dins➊dag
dinsdagavond	dins➋dag➊avond
direct	di➊rect
directe	di➊rec➊te
directeur	di➊rec➊teur
discussie	dis➊cus➊sie
dit	dit
diverse	di➊ver➊se
dividend	di➊vi➊dend
divisie	di➊vi➊sie
DNB	DNB
dochter	doch➊ter
dochters	doch➊ters
dochtertje	doch➋ter➊tje
document	do➊cu➊ment
documenten	do➊cu➊men➊ten
dode	do➊de
doden	do➊den
doe	doe
doel	doel
doelen	doe➊len
doen	doen
doet	doet
dollar	dol➊lar
donderdag	don➊der➊dag
donderdagavond	don➋der➋dag➊avond
dood	dood
door	door
doordat	door➊dat
doorgaan	door➊gaan
doorgaans	door➊gaans
doorsnee	door➊snee
dorp	dorp
doutzen	dout➊zen
Dow	Dow
draagt	draagt
draaien	draai➊en
draait	draait
dragen	dra➊gen
Draghi	Drag➊hi
drama	dra➊ma
drank	drank
dreigt	dreigt
drie	drie
drinken	drin➊ken
droeg	droeg
droom	droom
drugs	drugs
druk	druk
drukken	druk➊ken
drukte	druk➊te
DSM	DSM
dubbele	dub➊be➊le
duidelijk	dui➋de➊lijk
duidelijke	dui➋de➊lij➋ke
duidelijkheid	dui➋de➊lijk➊heid
Duitse	Duit➊se
Duitsers	Duit➊sers
Duitsland	Duits➊land
duizend	dui➊zend
duizenden	dui➊zen➊den
duo	duo
dure	du➊re
duren	du➊ren
dus	dus
duur	duur
duurder	duur➊der
duurt	duurt
duurzame	duur➊za➋me
ebitda	ebitda
ECB	ECB
echt	echt
echte	ech➊te
echter	ech➊ter
echtgenoot	echt➊ge➋noot
echtgenote	echt➊ge➋no➋te
economen	eco➊no➊men
economie	eco➊no➊mie
economieen	eco➊no➊mie➊en
economisch	eco➊no➊misch
economische	eco➊no➊mi➊sche
econoom	eco➊noom
editie	edi➊tie
een	een
eén	eén
één	één
eenmaal	een➊maal
eenmalige	een➊ma➊li➊ge
eens	eens
eerder	eer➊der
eerdere	eer➊de➊re
eerlijk	eer➊lijk
eerst	eerst
eerste	eer➊ste
eeuw	eeuw
effect	ef➊fect
effecten	ef➊fec➊ten
Egypte	Egyp➊te
eigen	ei➊gen
eigenaar	ei➊ge➊naar
eigenlijk	ei➋gen➊lijk
eiland	ei➊land
eind	eind
einde	ein➊de
eindelijk	ein➊de➊lijk
Eindhoven	Eind➊ho➋ven
eindigde	ein➊dig➊de
eisen	ei➊sen
eist	eist
elders	el➊ders
elektrische	elek➊tri➊sche
elf	elf
Elizabeth	Eli➊za➊beth
elk	elk
elkaar	el➊kaar
elke	el➊ke
ene	ene
energie	ener➊gie
Engeland	En➊ge➊land
Engelse	En➊gel➊se
enige	eni➊ge
enigszins	enigs➊zins
enkel	en➊kel
enkele	en➊ke➊le
enorm	enorm
enorme	enor➊me
enthousiast	en➊thou➊si➊ast
epa	epa
EPA	EPA
eraan	er➊aan
erbij	er➊bij
erg	erg
ergens	er➊gens
Eric	Eric
erin	er➊in
ernstig	ern➊stig
ernstige	ern➊sti➊ge
erop	er➊op
eruit	er➊uit
ervan	er➊van
ervaren	er➊va➋ren
ervaring	er➊va➋ring
ervoor	er➊voor
eten	eten
eur	eur
Eur	Eur
euro	eu➊ro
eurolanden	eu➋ro➊lan➋den
Euronext	Eu➋ro➊next
europa	eu➊ro➊pa
Europa	Eu➊ro➊pa
europees	eu➊ro➊pees
Europees	Eu➊ro➊pees
europese	eu➊ro➊pe➊se
Europese	Eu➊ro➊pe➊se
eurozone	eu➋ro➊zo➋ne
Eva	Eva
even	even
eveneens	even➊eens
evenement	eve➊ne➊ment
eventueel	even➊tu➊eel
eventuele	even➊tu➊e➊le
exclusief	ex➊clu➊sief
excuses	ex➊cu➊ses
experts	ex➊perts
export	ex➊port
express	ex➊press
extra	ex➊tra
extreem	ex➊treem
fabriek	fa➊briek
fabrikant	fa➊bri➊kant
Facebook	Face➊book
Fagron	Fa➊gron
failliet	fail➊liet
faillissement	fail➊lis➊se➊ment
familie	fa➊mi➊lie
fan	fan
fans	fans
fase	fa➊se
favoriete	fa➊vo➊rie➊te
feb	feb
februari	fe➊bru➊a➊ri
fed	fed
federal	fe➊de➊ral
feest	feest
feestje	feest➊je
feit	feit
festival	fes➊ti➊val
fiets	fiets
film	film
filmpje	film➊pje
films	films
finale	fi➊na➊le
financial	fi➊nan➊ci➊al
Financial	Fi➊nan➊ci➊al
financieel	fi➊nan➊ci➊eel
financiele	fi➊nan➊ci➊e➊le
Financien	Fi➊nan➊ci➊en
financiering	fi➊nan➊cie➊ring
fiscale	fis➊ca➊le
fjs	fjs
flink	flink
flinke	flin➊ke
FNV	FNV
focus	fo➊cus
fonds	fonds
fondsen	fond➊sen
for	for
Ford	Ford
fors	fors
forse	for➊se
foto	fo➊to
fout	fout
fouten	fou➊ten
fractie	frac➊tie
France	Fran➊ce
frank	frank
Frank	Frank
Frankfurt	Frank➊furt
Frankrijk	Frank➊rijk
frans	frans
Frans	Frans
franse	fran➊se
fraude	frau➊de
Fugro	Fug➊ro
functie	func➊tie
fusie	fu➊sie
gaan	gaan
gaat	gaat
gaf	gaf
gaga	ga➊ga
Galapagos	Ga➊la➊pa➊gos
game	ga➊me
games	ga➊mes
gang	gang
gas	gas
gast	gast
gasten	gas➊ten
gat	gat
gaten	ga➊ten
gaven	ga➊ven
gearresteerd	ge➊ar➋res➋teerd
gebaseerd	ge➊ba➋seerd
gebeurd	ge➊beurd
gebeurde	ge➊beur➋de
gebeuren	ge➊beu➋ren
gebeurt	ge➊beurt
gebied	ge➊bied
gebieden	ge➊bie➋den
gebleven	ge➊ble➋ven
geboekt	ge➊boekt
geboorte	ge➊boor➋te
geboren	ge➊bo➋ren
gebouw	ge➊bouw
gebouwd	ge➊bouwd
gebracht	ge➊bracht
gebrek	ge➊brek
gebroken	ge➊bro➋ken
gebruik	ge➊bruik
gebruiken	ge➊brui➋ken
gebruikers	ge➊brui➋kers
gebruikt	ge➊bruikt
gebruikte	ge➊bruik➋te
gedaald	ge➊daald
gedaan	ge➊daan
gedacht	ge➊dacht
gedeeld	ge➊deeld
gedood	ge➊dood
gedrag	ge➊drag
gedurende	ge➊du➋ren➋de
gedwongen	ge➊dwon➋gen
geef	geef
geeft	geeft
geeist	ge➊eist
geen	geen
Geert	Geert
gegaan	ge➊gaan
gegeven	ge➊ge➋ven
gegevens	ge➊ge➋vens
gegroeid	ge➊groeid
gehaald	ge➊haald
gehad	ge➊had
geheel	ge➊heel
geheim	ge➊heim
geheime	ge➊hei➊me
gehele	ge➊he➊le
geholpen	ge➊hol➋pen
gehoord	ge➊hoord
gehouden	ge➊hou➋den
gek	gek
gekeken	ge➊ke➋ken
gekocht	ge➊kocht
gekomen	ge➊ko➋men
gekozen	ge➊ko➋zen
gekregen	ge➊kre➋gen
geld	geld
gelden	gel➊den
geldt	geldt
geleden	ge➊le➋den
gelegd	ge➊legd
gelegen	ge➊le➋gen
gelegenheid	ge➊le➋gen➊heid
geleid	ge➊leid
geliefde	ge➊lief➋de
gelijk	ge➊lijk
geloof	ge➊loof
geloven	ge➊lo➋ven
geluk	ge➊luk
gelukkig	ge➊luk➊kig
gemaakt	ge➊maakt
Gemalto	Ge➊mal➊to
gemeente	ge➊meen➊te
gemeenten	ge➊meen➊ten
gemeld	ge➊meld
gemeten	ge➊me➊ten
gemiddeld	ge➊mid➊deld
gemiddelde	ge➊mid➊del➊de
generaal	ge➊ne➊raal
general	ge➊ne➊ral
General	Ge➊ne➊ral
geniet	ge➊niet
genieten	ge➊nie➊ten
genoeg	ge➊noeg
genoemd	ge➊noemd
genomen	ge➊no➋men
geopend	ge➊o➋pend
georganiseerd	ge➊or➋ga➋ni➊seerd
George	Geor➊ge
geplaatst	ge➊plaatst
gepland	ge➊pland
gepleegd	ge➊pleegd
gepresenteerd	ge➊pre➋sen➊teerd
geprobeerd	ge➊pro➋beerd
gepubliceerd	ge➊pu➋bli➊ceerd
gepubliceerde	ge➊pu➋bli➊ceer➋de
geraakt	ge➊raakt
Gerard	Ge➊rard
gereageerd	ge➊re➊a➊geerd
gerechtshof	ge➊rechts➊hof
gered	ge➊red
geregeld	ge➊re➋geld
gerekend	ge➊re➋kend
gericht	ge➊richt
geruchten	ge➊ruch➋ten
geschiedenis	ge➊schie➊de➋nis
geschikt	ge➊schikt
geschreven	ge➊schre➋ven
geslagen	ge➊sla➋gen
gesloten	ge➊slo➋ten
gespeeld	ge➊speeld
gespot	ge➊spot
gesprek	ge➊sprek
gesprekken	ge➊sprek➋ken
gesproken	ge➊spro➋ken
gestart	ge➊start
gestegen	ge➊ste➋gen
gesteld	ge➊steld
gestemd	ge➊stemd
gesteund	ge➊steund
gestolen	ge➊sto➋len
gestuurd	ge➊stuurd
getroffen	ge➊trof➋fen
getrokken	ge➊trok➋ken
getrouwd	ge➊trouwd
getuige	ge➊tui➊ge
getuigen	ge➊tui➊gen
gevaar	ge➊vaar
geval	ge➊val
gevallen	ge➊val➊len
gevangenis	ge➊van➋ge➊nis
geven	ge➊ven
gevestigd	ge➊ves➊tigd
gevoel	ge➊voel
gevolg	ge➊volg
gevolgd	ge➊volgd
gevolgen	ge➊vol➊gen
gevonden	ge➊von➊den
gevraagd	ge➊vraagd
geweest	ge➊weest
geweld	ge➊weld
geweldig	ge➊wel➊dig
geweldige	ge➊wel➊di➊ge
gewerkt	ge➊werkt
gewond	ge➊wond
gewonden	ge➊won➊den
gewone	ge➊wo➊ne
gewonnen	ge➊won➊nen
gewoon	ge➊woon
geworden	ge➊wor➊den
gezamenlijk	ge➊za➋men➊lijk
gezamenlijke	ge➊za➋men➊lij➋ke
gezegd	ge➊zegd
gezellig	ge➊zel➊lig
gezet	ge➊zet
gezicht	ge➊zicht
gezien	ge➊zien
gezin	ge➊zin
gezocht	ge➊zocht
gezond	ge➊zond
gezonde	ge➊zon➋de
gezondheid	ge➊zond➊heid
gezorgd	ge➊zorgd
Gilissen	Gi➊lis➊sen
ging	ging
gingen	gin➊gen
gisteren	gis➊te➊ren
global	glo➊bal
Global	Glo➊bal
goed	goed
goede	goe➊de
goederen	goe➊de➊ren
goedkeuring	goed➊keu➋ring
goedkoop	goed➊koop
goedkoper	goed➊ko➋per
Goldman	Gold➊man
Google	Goog➊le
Gordon	Gor➊don
goud	goud
gouden	gou➊den
graadmeter	graad➊me➋ter
graag	graag
graden	gra➊den
grafiek	gra➊fiek
gratis	gra➊tis
greep	greep
grens	grens
Grieken	Grie➊ken
Griekenland	Grie➋ken➊land
Griekse	Griek➊se
groei	groei
groeide	groei➊de
groeien	groei➊en
groeiende	groei➊en➋de
groeit	groeit
groen	groen
groene	groe➊ne
groenlinks	groen➊links
Groenlinks	Groen➊links
GroenLinks	Groen➊Links
groep	groep
groepen	groe➊pen
grond	grond
grondstoffen	grond➊stof➋fen
Groningen	Gro➊nin➊gen
groot	groot
grootste	groot➊ste
grote	gro➊te
grotendeels	gro➋ten➊deels
groter	gro➊ter
grotere	gro➊te➊re
group	group
Group	Group
gunstig	gun➊stig
haag	haag
Haag	Haag
Haagse	Haag➊se
haalde	haal➊de
haalt	haalt
haar	haar
had	had
hadden	had➊den
halen	ha➊len
half	half
halfjaar	half➊jaar
halve	hal➊ve
hand	hand
handel	han➊del
handelaar	han➊de➊laar
handelen	han➊de➊len
handelsdag	han➊dels➊dag
handen	han➊den
hang	hang
Hang	Hang
hangen	han➊gen
hangt	hangt
hans	hans
Hans	Hans
hanteert	han➊teert
hard	hard
harde	har➊de
harder	har➊der
Harry	Har➊ry
hart	hart
haven	ha➊ven
heb	heb
hebben	heb➊ben
hebt	hebt
heeft	heeft
heel	heel
heen	heen
heerlijk	heer➊lijk
heet	heet
Heijmans	Heij➊mans
Heineken	Hei➊ne➊ken
helaas	he➊laas
hele	he➊le
helemaal	he➋le➊maal
helft	helft
helpen	hel➊pen
helpt	helpt
hem	hem
hen	hen
henk	henk
Henk	Henk
herstel	her➊stel
herstellen	her➊stel➊len
hervormingen	her➊vor➊min➊gen
het	het
hetzelfde	het➊zelf➊de
hield	hield
hielden	hiel➊den
hier	hier
hierbij	hier➊bij
hierdoor	hier➊door
Hierdoor	Hier➊door
hiermee	hier➊mee
hieronder	hier➊on➊der
hierover	hier➊over
hiervan	hier➊van
hiervoor	hier➊voor
high	high
hij	hij
historisch	his➊to➊risch
historische	his➊to➊ri➊sche
hit	hit
hoe	hoe
hoeft	hoeft
hoek	hoek
hoeveel	hoe➊veel
hoeveelheid	hoe➊veel➊heid
hoeven	hoe➊ven
hoewel	hoe➊wel
Hoewel	Hoe➊wel
hof	hof
hoge	ho➊ge
hoger	ho➊ger
hogere	ho➊ge➊re
hold	hold
Holland	Hol➊land
Hollandse	Hol➊land➊se
Hollywood	Hol➋ly➊wood
hond	hond
honderd	hon➊derd
honderden	hon➊der➊den
Hongkong	Hong➊kong
hoofd	hoofd
hoofdkantoor	hoofd➊kan➊toor
hoofdrol	hoofd➊rol
hoofdstad	hoofd➊stad
hoog	hoog
hoogste	hoog➊ste
hoogte	hoog➊te
Hoogte	Hoog➊te
hoop	hoop
hoopt	hoopt
hoor	hoor
hoorde	hoor➊de
hoort	hoort
hopen	ho➊pen
horen	ho➊ren
hotel	ho➊tel
hotels	ho➊tels
hou	hou
houden	hou➊den
houdt	houdt
huidige	hui➊di➋ge
huis	huis
huishoudens	huis➊hou➋dens
huizen	hui➊zen
huizenmarkt	hui➋zen➊markt
hulp	hulp
hun	hun
huwelijk	hu➋we➊lijk
hypotheek	hy➋po➊theek
hypotheken	hy➋po➊the➋ken
ICT	ICT
idee	idee
ieder	ie➊der
iedere	ie➊de➊re
iedereen	ie➊der➊een
iemand	ie➊mand
Ierland	Ier➊land
Ierse	Ier➊se
iets	iets
illegale	il➊le➊ga➊le
IMF	IMF
immers	im➊mers
impact	im➊pact
Imtech	Im➊tech
incident	in➊ci➊dent
inclusief	in➊clu➊sief
inderdaad	in➊der➊daad
index	in➊dex
India	In➊dia
Indiase	In➊di➊a➊se
individuele	in➊di➊vi➊du➊e➊le
indruk	in➊druk
industrie	in➊du➊strie
industriele	in➊du➊stri➊e➊le
ineens	in➊eens
inflatie	in➊fla➊tie
informatie	in➊for➊ma➊tie
infrastructuur	in➋fra➊struc➋tuur
Ing	Ing
ingediend	in➊ge➊diend
ingewijde	in➊ge➊wij➊de
ingewijden	in➊ge➊wij➊den
ingezet	in➊ge➊zet
initiatief	ini➊ti➊a➊tief
inkomen	in➊ko➋men
inkomsten	in➊kom➋sten
inkoopmanagersindex	in➋koop➊ma➋na➋gers➊in➋dex
inmiddels	in➊mid➋dels
insider	in➊si➋der
Instagram	In➋sta➊gram
instantie	in➊stan➊tie
instellingen	in➊stel➊lin➊gen
interessant	in➊te➊res➊sant
interesse	in➊te➊res➊se
internationaal	in➋ter➊na➊ti➊o➊naal
international	in➋ter➊na➊ti➊o➊nal
internationale	in➊ter➊na➊ti➊o➊na➊le
internet	in➋ter➊net
interview	in➋ter➊view
investeerder	in➊ves➊teer➊der
investeerders	in➊ves➊teer➊ders
investeren	in➊ves➊te➊ren
investering	in➊ves➊te➊ring
investeringen	in➊ves➊te➊rin➊gen
invloed	in➊vloed
inwoners	in➊wo➊ners
inzet	in➊zet
inzetten	in➊zet➊ten
Irak	Irak
Iran	Iran
islamitische	is➊la➊mi➊ti➊sche
Israel	Is➊ra➊el
Israelische	Is➊ra➊e➊li➊sche
Italiaanse	Ita➊li➊aan➊se
Italië	Ita➊lië
jaar	jaar
jaarbasis	jaar➊ba➋sis
jaarlijks	jaar➊lijks
jaarlijkse	jaar➊lijk➋se
jacht	jacht
Jackson	Jack➊son
James	Ja➊mes
jammer	jam➊mer
Janet	Ja➊net
Jansen	Jan➊sen
januari	ja➊nu➊a➊ri
Japan	Ja➊pan
Japanse	Ja➊pan➊se
jaren	ja➊ren
jarenlang	ja➋ren➊lang
jarig	ja➊rig
jarige	ja➊ri➊ge
Jay	Jay
Jean	Jean
Jenner	Jen➊ner
Jennifer	Jen➊ni➊fer
Jeroen	Je➊roen
Jessica	Jes➊si➊ca
jeugd	jeugd
jij	jij
Jim	Jim
Johan	Joh➊an
John	John
Johnny	John➊ny
Jones	Jo➊nes
Jonesindex	Jo➋nes➊in➋dex
jong	jong
Jong	Jong
jonge	jon➊ge
jongen	jon➊gen
jongens	jon➊gens
jongere	jon➊ge➊re
jongeren	jon➊ge➊ren
jongetje	jon➊ge➊tje
jongste	jong➊ste
Jos	Jos
jou	jou
jouw	jouw
JPMorgan	JP➊Mor➋gan
juist	juist
juiste	juis➊te
juli	ju➊li
jullie	jul➊lie
juni	ju➊ni
juridische	ju➋ri➊di➊sche
jurk	jurk
jury	ju➊ry
Justin	Jus➊tin
justitie	jus➊ti➊tie
kaart	kaart
kaarten	kaar➊ten
kabinet	ka➊bi➊net
kamer	ka➊mer
kamerlid	ka➋mer➊lid
Kamp	Kamp
kampen	kam➊pen
kampt	kampt
kan	kan
kandidaat	kan➊di➊daat
kandidaten	kan➊di➊da➊ten
kanker	kan➊ker
kans	kans
kansen	kan➊sen
kant	kant
kantoor	kan➊toor
Kanye	Ka➊nye
kapitaal	ka➊pi➊taal
kapitaalbelang	ka➋pi➋taal➊be➋lang
Kardashian	Kar➊das➊hi➊an
Kate	Kate
Katie	Ka➊tie
Katy	Ka➊ty
KBC	KBC
keer	keer
keert	keert
Kelly	Kel➊ly
Kendall	Ken➊dall
kennen	ken➊nen
kennis	ken➊nis
kent	kent
keren	ke➊ren
kerk	kerk
kerst	kerst
keuze	keu➊ze
Khloé	Khloé
kiekje	kiek➊je
kiest	kiest
kiezen	kie➊zen
kijk	kijk
kijken	kij➊ken
kijkers	kij➊kers
kijkt	kijkt
kilo	ki➊lo
kilometer	ki➋lo➊me➋ter
Kim	Kim
kind	kind
kinderen	kin➊de➊ren
kindje	kind➊je
king	king
King	King
klaar	klaar
klachten	klach➊ten
klant	klant
klanten	klan➊ten
klap	klap
kleding	kle➊ding
klein	klein
kleine	klei➊ne
kleiner	klei➊ner
kleinere	klei➊ne➊re
klik	klik
klimaat	kli➊maat
kliniek	kli➊niek
KLM	KLM
klom	klom
kocht	kocht
koers	koers
koersdoel	koers➊doel
koersen	koer➊sen
koffie	kof➊fie
kom	kom
komen	ko➊men
komend	ko➊mend
komende	ko➊men➊de
komst	komst
komt	komt
kon	kon
konden	kon➊den
kondigde	kon➊dig➊de
koning	ko➊ning
koningin	ko➊nin➊gin
koninklijke	ko➋nink➊lij➋ke
Koninklijke	Ko➋nink➊lij➋ke
koninkrijk	ko➋nink➊rijk
Koninkrijk	Ko➋nink➊rijk
koop	koop
koopadvies	koop➊ad➋vies
koopt	koopt
koos	koos
kop	kop
kopen	ko➊pen
koper	ko➊per
kopers	ko➊pers
koppel	kop➊pel
Korea	Ko➊rea
Koreaanse	Ko➊re➊aan➊se
kort	kort
korte	kor➊te
korting	kor➊ting
Kospi	Kos➊pi
kost	kost
kosten	kos➊ten
kostenbesparingen	kos➋ten➊be➋spa➋rin➋gen
kostte	kost➊te
Kourtney	Kourt➊ney
KPN	KPN
kracht	kracht
krant	krant
kredietbeoordelaar	kre➋diet➊be➋oor➋de➋laar
kreeg	kreeg
kregen	kre➊gen
krijg	krijg
krijgen	krij➊gen
krijgt	krijgt
krimp	krimp
kris	kris
Kris	Kris
kritiek	kri➊tiek
Kroes	Kroes
kroon	kroon
kun	kun
kunnen	kun➊nen
kunst	kunst
kunt	kunt
kust	kust
kwaliteit	kwa➊li➊teit
kwam	kwam
kwamen	kwa➊men
kwart	kwart
kwartaal	kwar➊taal
kwartaalcijfers	kwar➋taal➊cij➋fers
kwestie	kwes➊tie
kwijt	kwijt
Kylie	Ky➊lie
laag	laag
laagste	laag➊ste
laat	laat
laatst	laatst
laatste	laat➊ste
lachen	la➊chen
lady	la➊dy
lag	lag
lage	la➊ge
lagen	la➊gen
lager	la➊ger
lagere	la➊ge➊re
Lamar	La➊mar
land	land
landelijke	lan➋de➊lij➋ke
landen	lan➊den
lang	lang
lange	lan➊ge
langer	lan➊ger
langere	lan➊ge➊re
langs	langs
langzaam	lang➊zaam
last	last
lastig	las➊tig
laten	la➊ten
later	la➊ter
league	lea➊gue
League	Lea➊gue
leden	le➊den
leed	leed
leeftijd	leef➊tijd
leek	leek
leerlingen	leer➊lin➋gen
lees	lees
Lees	Lees
legde	leg➊de
leger	le➊ger
leggen	leg➊gen
legt	legt
leidde	leid➊de
leiden	lei➊den
leider	lei➊der
leiders	lei➊ders
leiding	lei➊ding
leidt	leidt
lekker	lek➊ker
lenen	le➊nen
lening	le➊ning
leningen	le➊nin➊gen
leren	le➊ren
leuk	leuk
leuke	leu➊ke
leven	le➊ven
leverde	le➊ver➊de
leveren	le➊ve➊ren
levert	le➊vert
lezen	le➊zen
lezers	le➊zers
Liam	Li➊am
lichaam	li➊chaam
licht	licht
lichte	lich➊te
lid	lid
lidstaten	lid➊sta➊ten
liefde	lief➊de
liefst	liefst
liep	liep
liepen	lie➊pen
liet	liet
lieten	lie➊ten
lieve	lie➊ve
liever	lie➊ver
lift	lift
liggen	lig➊gen
ligt	ligt
lijden	lij➊den
lijf	lijf
lijken	lij➊ken
lijkt	lijkt
lijn	lijn
lijst	lijst
Limburg	Lim➊burg
Linda	Lin➊da
Lindsay	Lind➊say
links	links
liter	li➊ter
live	li➊ve
Lloyd	Lloyd
LLoyd	Lloyd
locatie	lo➊ca➊tie
log	log
Log	Log
lokale	lo➊ka➊le
londen	lon➊den
Londen	Lon➊den
loop	loop
loopt	loopt
looptijd	loop➊tijd
lopen	lo➊pen
lopende	lo➊pen➊de
loper	lo➊per
los	los
lossen	los➊sen
Louis	Louis
lucht	lucht
luchthaven	lucht➊ha➋ven
luchtvaartmaatschappij	lucht➊vaart➊maat➋schap➋pij
luidt	luidt
lukt	lukt
luxe	luxe
maak	maak
Maak	Maak
maakt	maakt
maakte	maak➊te
maakten	maak➊ten
maand	maand
maandag	maan➊dag
maandagavond	maan➋dag➊avond
maandagochtend	maan➋dag➊och➋tend
maanden	maan➊den
maar	maar
maart	maart
Maarten	Maar➊ten
Maastricht	Maas➊tricht
maatregel	maat➊re➋gel
maatregelen	maat➊re➋ge➋len
maatschappij	maat➊schap➋pij
macht	macht
macro	ma➊cro
Madonna	Ma➊don➊na
mag	mag
magazine	ma➊ga➊zi➊ne
mail	mail
maken	ma➊ken
makkelijk	mak➋ke➊lijk
makkelijker	mak➋ke➊lij➋ker
man	man
management	ma➊na➊ge➊ment
manager	ma➊na➊ger
Manchester	Man➊ches➊ter
manier	ma➊nier
mannen	man➊nen
Marc	Marc
Marco	Mar➊co
Mario	Ma➊rio
Mark	Mark
markt	markt
marktaandeel	markt➊aan➋deel
markten	mark➊ten
marktomstandigheden	markt➊om➋stan➋dig➊he➋den
Martijn	Mar➊tijn
Martin	Mar➊tin
massaal	mas➊saal
mate	ma➊te
Máxima	Má➊xi➊ma
maximaal	ma➋xi➊maal
May	May
mede	me➊de
medewerker	me➋de➊wer➋ker
medewerkers	me➋de➊wer➋kers
media	me➊dia
medicijnen	me➊di➊cij➊nen
medio	me➊dio
medisch	me➊disch
medische	me➊di➊sche
mee	mee
meedoen	mee➊doen
meegenomen	mee➊ge➊no➊men
meent	meent
meer	meer
meerdere	meer➊de➊re
meerderheid	meer➋der➊heid
meest	meest
meestal	meest➊al
meeste	mees➊te
mei	mei
meisje	meis➊je
meisjes	meis➊jes
meldde	meld➊de
meldden	meld➊den
melden	mel➊den
melding	mel➊ding
meldingen	mel➊din➊gen
meldt	meldt
men	men
mening	me➊ning
mens	mens
mensen	men➊sen
merk	merk
Merkel	Mer➊kel
MERKEL	MER➊KEL
merken	mer➊ken
mes	mes
met	met
meteen	met➊een
meter	me➊ter
Mexico	Mexi➊co
mezelf	me➊zelf
Michael	Mi➊cha➊el
Microsoft	Mi➋cro➊soft
middag	mid➊dag
middel	mid➊del
middelen	mid➊de➊len
midden	mid➊den
midkap	mid➊kap
Midkap	Mid➊kap
mij	mij
mijn	mijn
Miley	Mi➊ley
milieu	mi➊li➊eu
Milieu	Mi➊li➊eu
militaire	mi➊li➊tai➊re
militairen	mi➊li➊tai➊ren
miljard	mil➊jard
miljarden	mil➊jar➊den
miljoen	mil➊joen
miljoenen	mil➊joe➊nen
min	min
minder	min➊der
minimaal	mi➊ni➊maal
minister	mi➊nis➊ter
ministerie	mi➊nis➊te➊rie
ministers	mi➊nis➊ters
minstens	min➊stens
minuten	mi➊nu➊ten
minuut	mi➊nuut
mis	mis
misbruik	mis➊bruik
mishandeling	mis➊han➊de➊ling
misschien	mis➊schien
missen	mis➊sen
missie	mis➊sie
mist	mist
mkb	mkb
mobiele	mo➊bie➊le
mocht	mocht
mochten	moch➊ten
model	mo➊del
modellen	mo➊del➊len
moeder	moe➊der
moederbedrijf	moe➋der➊be➋drijf
moeilijk	moei➊lijk
moeilijke	moei➊lij➋ke
moeite	moei➊te
moest	moest
moesten	moesten
moet	moet
moeten	moe➊ten
mogelijk	mo➋ge➊lijk
mogelijke	mo➋ge➊lij➋ke
mogelijkheden	mo➋ge➊lijk➊he➋den
mogelijkheid	mo➋ge➊lijk➊heid
mogen	mo➊gen
mol	mol
Mol	Mol
moment	mo➊ment
momenteel	mo➊men➊teel
mon	mon
Mon	Mon
mond	mond
monetaire	mo➊ne➊tai➊re
Moody	Moo➊dy
mooi	mooi
mooie	mooie
mooiste	mooi➊ste
moord	moord
Morgan	Mor➊gan
morgen	mor➊gen
Moskou	Mos➊kou
motor	mo➊tor
munt	munt
museum	mu➊se➊um
musical	mu➊si➊cal
muziek	mu➊ziek
naam	naam
naar	naar
naast	naast
nabestaanden	na➊be➋staan➋den
nadat	na➊dat
nader	na➊der
nagenoeg	na➊ge➊noeg
najaar	na➊jaar
nam	nam
name	na➊me
namelijk	na➋me➊lijk
namen	na➊men
namens	na➊mens
Nasdaq	Nas➊daq
NASDAQ	NAS➊DAQ
nationale	na➊ti➊o➊na➊le
natuur	na➊tuur
natuurlijk	na➋tuur➊lijk
nauwelijks	nau➋we➊lijks
nederland	ne➋der➊land
Nederland	Ne➋der➊land
Nederlander	Ne➋der➊lan➋der
Nederlanders	Ne➋der➊lan➋ders
nederlands	ne➋der➊lands
Nederlands	Ne➋der➊lands
Nederlandsche	Ne➋der➊land➋sche
nederlandse	ne➋der➊land➋se
Nederlandse	Ne➋der➊land➋se
nee	nee
Nee	Nee
neem	neem
neemt	neemt
neer	neer
negatief	ne➋ga➊tief
negatieve	ne➋ga➊tie➋ve
negen	ne➊gen
nemen	ne➊men
net	net
netto	net➊to
nettowinst	net➋to➊winst
netwerk	net➊werk
new	new
New	New
news	news
Nick	Nick
niemand	nie➊mand
niet	niet
niets	niets
nieuw	nieuw
nieuwe	nieu➊we
nieuws	nieuws
nieuwste	nieuw➊ste
Nikkei	Nik➊kei
niks	niks
niveau	ni➊veau
nodig	no➊dig
nodige	no➊di➊ge
noemde	noem➊de
noemen	noe➊men
noemt	noemt
nog	nog
nogal	nog➊al
noodzakelijk	nood➊za➋ke➊lijk
nooit	nooit
noord	noord
Noord	Noord
noorden	noor➊den
Noorse	Noor➊se
normaal	nor➊maal
normale	nor➊ma➊le
nos	nos
noteerde	no➊teer➊de
nou	nou
november	no➊vem➊ber
null	null
nummer	num➊mer
nummers	num➊mers
Obama	Oba➊ma
obligaties	obli➊ga➊ties
ochtend	och➊tend
Oekraine	Oek➊ra➊i➊ne
officieel	of➊fi➊ci➊eel
officiele	of➊fi➊ci➊e➊le
officier	of➊fi➊cier
offshore	off➊shore
ofwel	of➊wel
ogen	ogen
oktober	ok➊to➊ber
olie	olie
olieprijs	olie➊prijs
olieprijzen	olie➊prij➋zen
olympische	olym➊pi➊sche
omdat	om➊dat
omgerekend	om➊ge➊re➊kend
omgeving	om➊ge➊ving
omhoog	om➊hoog
omlaag	om➊laag
omroep	om➊roep
omstandigheden	om➋stan➋dig➊he➋den
omstreden	om➊stre➊den
omvang	om➊vang
omzet	om➊zet
omzetgroei	om➋zet➊groei
onafhankelijke	on➊af➊han➋ke➊lij➋ke
onbekend	on➊be➋kend
onbekende	on➊be➋ken➋de
ondanks	on➊danks
onder	on➊der
onderdeel	on➋der➊deel
onderdelen	on➋der➊de➋len
onderhandelingen	on➋der➊han➋de➋lin➋gen
onderliggende	on➋der➊lig➋gen➋de
ondernemen	on➋der➊ne➋men
ondernemer	on➋der➊ne➋mer
ondernemers	on➋der➊ne➋mers
onderneming	on➋der➊ne➋ming
ondernemingen	on➋der➊ne➋min➋gen
ondertussen	on➋der➊tus➋sen
onderuit	on➋der➊uit
onderweg	on➋der➊weg
onderwerp	on➋der➊werp
onderwerpen	on➋der➊wer➋pen
onderwijs	on➋der➊wijs
onderzocht	on➋der➊zocht
onderzoek	on➋der➊zoek
onderzoeken	on➋der➊zoe➋ken
onderzoekers	on➋der➊zoe➋kers
onderzoeksbureau	on➋der➊zoeks➊bu➋reau
onderzoekt	on➋der➊zoekt
onduidelijk	on➊dui➊de➊lijk
one	one
ongeluk	on➊ge➊luk
ongeval	on➊ge➊val
ongeveer	on➊ge➊veer
onlangs	on➊langs
online	on➊li➊ne
onrust	on➊rust
ons	ons
ontdekt	ont➊dekt
onthulde	ont➊hul➊de
onthult	ont➊hult
ontkent	ont➊kent
ontmoeting	ont➊moe➊ting
ontslag	ont➊slag
ontslagen	ont➊sla➊gen
ontstaan	ont➊staan
ontstaat	ont➊staat
ontstond	ont➊stond
ontvangen	ont➊van➊gen
ontvangt	ont➊vangt
ontwikkeld	ont➊wik➊keld
ontwikkelen	ont➊wik➊ke➊len
ontwikkeling	ont➊wik➊ke➊ling
ontwikkelingen	ont➊wik➊ke➊lin➊gen
ontzettend	ont➊zet➊tend
onveranderd	on➊ver➊an➊derd
onverwacht	on➊ver➊wacht
onvoldoende	on➊vol➊doen➊de
onze	on➊ze
onzekerheid	on➊ze➋ker➊heid
oog	oog
ooit	ooit
ook	ook
oordeel	oor➊deel
oorlog	oor➊log
oorzaak	oor➊zaak
oost	oost
Oost	Oost
oosten	oos➊ten
Oostenrijk	Oos➋ten➊rijk
opbrengst	op➊brengst
opbrengsten	op➊breng➊sten
opdracht	op➊dracht
open	open
openbaar	open➊baar
Openbaar	Open➊baar
openbare	open➊ba➋re
opende	open➊de
openen	ope➊nen
opening	ope➊ning
opent	opent
operatie	ope➊ra➊tie
operationeel	ope➊ra➊ti➊o➊neel
operationele	ope➊ra➊ti➊o➊ne➊le
opgehaald	op➊ge➋haald
opgelegd	op➊ge➋legd
opgelopen	op➊ge➋lo➋pen
opgenomen	op➊ge➋no➋men
opgepakt	op➊ge➋pakt
opgericht	op➊ge➋richt
opgeroepen	op➊ge➊roe➊pen
opkomende	op➊ko➊men➊de
opleiding	op➊lei➊ding
opleveren	op➊le➊ve➊ren
oplopen	op➊lo➊pen
oplossing	op➊los➋sing
opmars	op➊mars
opmerkelijke	op➊mer➊ke➊lij➊ke
opnames	op➊na➊mes
opnemen	op➊ne➊men
opnieuw	op➊nieuw
oppositie	op➊po➊si➊tie
oprichter	op➊rich➋ter
oproep	op➊roep
optie	op➊tie
opties	op➊ties
optreden	op➊tre➊den
optredens	op➊tre➊dens
opvallend	op➊val➊lend
opvolger	op➊vol➊ger
opzichte	op➊zich➊te
oranje	oran➊je
Oranje	Oran➊je
orde	or➊de
orders	or➊ders
organisatie	or➊ga➊ni➊sa➊tie
organisaties	or➊ga➊ni➊sa➊ties
oud	oud
oude	ou➊de
ouder	ou➊der
oudere	ou➊de➊re
ouderen	ou➊de➊ren
ouders	ou➊ders
oudste	oud➊ste
out	out
over	over
overal	over➊al
overeenkomst	over➋een➊komst
overgenomen	over➊ge➋no➋men
overheden	over➊he➋den
overheid	over➊heid
overige	ove➊ri➊ge
overigens	ove➊ri➊gens
overleden	over➊le➋den
overleed	over➊leed
overleg	over➊leg
overlijden	over➊lij➊den
overname	over➊na➋me
overnames	over➊na➋mes
overnemen	over➊ne➋men
overtuigd	over➊tuigd
overweegt	over➊weegt
overwegend	over➊we➋gend
overzicht	over➊zicht
paar	paar
pad	pad
pagina	pa➊gi➊na
pakken	pak➊ken
pakket	pak➊ket
paleis	pa➊leis
pand	pand
paniek	pa➊niek
Parijs	Pa➊rijs
Paris	Pa➊ris
park	park
parlement	par➋le➊ment
particuliere	par➊ti➊cu➊lie➊re
partij	par➊tij
partijen	par➊tij➊en
partner	part➊ner
partners	part➊ners
pas	pas
passagiers	pas➊sa➊giers
passen	pas➊sen
past	past
patienten	pa➊ti➊en➊ten
Patrick	Pa➊trick
Paul	Paul
paus	paus
peil	peil
peiling	pei➊ling
pensioen	pen➊si➊oen
pensioenfondsen	pen➋si➋oen➊fond➋sen
people	peo➊ple
per	per
percentage	per➊cen➊ta➊ge
persbureau	pers➊bu➋reau
persconferentie	pers➊con➋fe➋ren➋tie
personeel	per➊so➊neel
personen	per➊so➊nen
persoon	per➊soon
persoonlijk	per➋soon➊lijk
persoonlijke	per➋soon➊lij➋ke
Peter	Pe➊ter
Philips	Phi➊lips
Piet	Piet
Pieter	Pie➊ter
pijn	pijn
piloten	pi➊lo➊ten
plaat	plaat
plaats	plaats
plaatsen	plaat➊sen
plaatste	plaat➊ste
plaatsvinden	plaats➊vin➋den
plan	plan
plannen	plan➊nen
platform	plat➊form
plek	plek
plekken	plek➊ken
ploeg	ploeg
plotseling	plot➊se➊ling
plus	plus
podium	po➊di➊um
Poetin	Poe➊tin
poging	po➊ging
polen	po➊len
Polen	Po➊len
politici	po➊li➊ti➊ci
politie	po➊li➊tie
politiek	po➊li➊tiek
politieke	po➊li➊tie➊ke
pond	pond
populair	po➊pu➊lair
populaire	po➊pu➊lai➊re
portefeuille	por➊te➊feuil➊le
Portugal	Por➊tu➊gal
positie	po➊si➊tie
positief	po➊si➊tief
posities	po➊si➊ties
positieve	po➊si➊tie➊ve
post	post
Post	Post
PostNL	PostNL
praat	praat
prachtig	prach➊tig
prachtige	prach➊ti➊ge
praktijk	prak➊tijk
praten	pra➊ten
precies	pre➊cies
premie	pre➊mie
premier	pre➊mier
première	pre➊mi➊è➊re
presentatie	pre➊sen➊ta➊tie
presentator	pre➊sen➊ta➊tor
presentatrice	pre➊sen➊ta➊tri➊ce
presenteerde	pre➊sen➊teer➊de
presenteert	pre➊sen➊teert
presenteren	pre➊sen➊te➊ren
president	pre➊si➊dent
prestaties	pres➊ta➊ties
prijs	prijs
prijzen	prij➊zen
prima	pri➊ma
prince	prin➊ce
prins	prins
prinses	prin➊ses
private	pri➊va➊te
privé	pri➊vé
probeerde	pro➊beer➊de
probeert	pro➊beert
proberen	pro➊be➊ren
probleem	pro➊bleem
problemen	pro➊ble➊men
procent	pro➊cent
proces	pro➊ces
producent	pro➊du➊cent
product	pro➊duct
producten	pro➊duc➊ten
productie	pro➊duc➊tie
profiteren	pro➊fi➊te➊ren
prognose	prog➊no➊se
programma	pro➊gram➊ma
project	pro➊ject
projecten	pro➊jec➊ten
provincie	pro➊vin➊cie
publicatie	pu➊bli➊ca➊tie
publiek	pu➊bliek
publieke	pu➊blie➊ke
punt	punt
punten	pun➊ten
PvdA	PvdA
PVV	PVV
raad	raad
raakt	raakt
raakte	raak➊te
raakten	raak➊ten
Rabo	Rabo
Rabobank	Ra➋bo➊bank
race	ra➊ce
radio	ra➊dio
Rafael	Ra➊fael
raken	ra➊ken
raming	ra➊ming
randstad	rand➊stad
Randstad	Rand➊stad
rapper	rap➊per
rapport	rap➊port
reaal	re➊aal
Reaal	Re➊aal
reactie	re➊ac➊tie
reacties	re➊ac➊ties
reageerde	re➊a➊geer➊de
reageert	re➊a➊geert
reageren	re➊a➊ge➊ren
realiseren	re➊a➊li➊se➊ren
realityster	re➊a➊li➊ty➊ster
rebellen	re➊bel➊len
recent	re➊cent
recente	re➊cen➊te
recessie	re➊ces➊sie
recht	recht
rechtbank	recht➊bank
rechten	rech➊ten
rechter	rech➊ter
rechters	rech➊ters
rechtszaak	rechts➊zaak
record	re➊cord
redden	red➊den
redelijk	re➋de➊lijk
reden	re➊den
redenen	re➊de➊nen
reed	reed
reeks	reeks
referendum	re➊fe➊ren➊dum
regeling	re➊ge➊ling
regelmatig	re➋gel➊ma➋tig
regels	re➊gels
regen	re➊gen
regering	re➊ge➊ring
regime	re➊gi➊me
regio	re➊gio
regionale	re➊gi➊o➊na➊le
regisseur	re➊gis➊seur
reis	reis
reizen	rei➊zen
reizigers	rei➊zi➊gers
rekenden	re➊ken➊den
rekenen	re➊ke➊nen
rekening	re➊ke➊ning
rekent	re➊kent
relatie	re➊la➊tie
relatief	re➊la➊tief
rendement	ren➊de➊ment
rendementen	ren➊de➊men➊ten
rente	ren➊te
rentes	ren➊tes
renteverhoging	ren➋te➊ver➋ho➋ging
reorganisatie	re➊or➋ga➊ni➊sa➊tie
reserve	re➊ser➊ve
Reserve	Re➊ser➊ve
respect	res➊pect
respectievelijk	res➊pec➊tie➊ve➊lijk
rest	rest
restaurant	res➊tau➊rant
resultaat	re➊sul➊taat
resultaten	re➊sul➊ta➊ten
reuters	reu➊ters
Reuters	Reu➊ters
Richard	Ri➊chard
richt	richt
richten	rich➊ten
richting	rich➊ting
riep	riep
Rihanna	Ri➊han➊na
rij	rij
rijden	rij➊den
rijk	rijk
Rijn	Rijn
ring	ring
risico	ri➊si➊co
Rob	Rob
Robert	Ro➊bert
Robin	Ro➊bin
rode	ro➊de
roepen	roe➊pen
roept	roept
rol	rol
rollen	rol➊len
Ronald	Ro➊nald
rond	rond
ronde	ron➊de
rondom	rond➊om
rood	rood
Rotterdam	Rot➋ter➊dam
Rotterdamse	Rot➋ter➊dam➋se
route	rou➊te
royal	roy➊al
Royal	Roy➊al
RTL	RTL
rug	rug
ruim	ruim
ruime	rui➊me
ruimte	ruim➊te
Rusland	Rus➊land
Russische	Rus➊si➊sche
rust	rust
rustig	rus➊tig
Rutte	Rut➊te
Ruud	Ruud
ruzie	ru➊zie
Ryan	Ry➊an
Sabia	Sa➊bia
Sachs	Sachs
salaris	sa➊la➊ris
saldo	sal➊do
samen	sa➊men
samenleving	sa➋men➊le➋ving
samenwerken	sa➋men➊wer➋ken
samenwerking	sa➋men➊wer➋king
Samsom	Sam➊som
sancties	sanc➊ties
SBM	SBM
scenario	sce➊na➊rio
schaal	schaal
schade	scha➊de
schadevergoeding	scha➋de➊ver➋goe➋ding
schatting	schat➊ting
scheiding	schei➊ding
schepen	sche➊pen
scherp	scherp
schietpartij	schiet➊par➊tij
schikking	schik➊king
schip	schip
Schiphol	Schip➊hol
schoenen	schoe➊nen
scholen	scho➊len
school	school
schoot	schoot
schrappen	schrap➊pen
schreef	schreef
schrijft	schrijft
schrijven	schrij➊ven
schuld	schuld
schulden	schul➊den
schuldig	schul➊dig
Scott	Scott
sector	sec➊tor
sectoren	sec➊to➊ren
securities	se➊cu➊ri➊ties
seizoen	sei➊zoen
seks	seks
seksueel	sek➊su➊eel
Selena	Se➊le➊na
seminar	se➊mi➊nar
senaat	se➊naat
Senaat	Se➊naat
Seng	Seng
sentiment	sen➊ti➊ment
Seoul	Se➊oul
september	sep➊tem➊ber
serie	se➊rie
serieus	se➊ri➊eus
set	set
sexy	sexy
sfeer	sfeer
Shanghai	Shang➊hai
shell	shell
Shell	Shell
show	show
signaal	sig➊naal
signalen	sig➊na➊len
Simon	Si➊mon
sinds	sinds
sindsdien	sinds➊dien
single	sin➊gle
sint	sint
Sint	Sint
site	si➊te
situatie	si➊tu➊a➊tie
slaan	slaan
slaat	slaat
slachtoffer	slacht➊of➋fer
slachtoffers	slacht➊of➋fers
slag	slag
slapen	sla➊pen
slecht	slecht
slechte	slech➊te
slechts	slechts
slim	slim
sloeg	sloeg
sloot	sloot
slot	slot
sloten	slo➊ten
sluit	sluit
sluiten	slui➊ten
sluiting	slui➊ting
smartphone	smart➊pho➋ne
sneeuw	sneeuw
snel	snel
snelheid	snel➊heid
snelle	snel➊le
sneller	snel➊ler
snelweg	snel➊weg
SNS	SNS
sociaal	so➊ci➊aal
social	so➊ci➊al
sociale	so➊ci➊a➊le
software	soft➊wa➋re
sommige	som➊mi➊ge
soms	soms
soort	soort
spaanse	spaan➊se
Spaanse	Spaan➊se
spaargeld	spaar➊geld
Spanje	Span➊je
spanningen	span➊nin➊gen
sparen	spa➊ren
speciaal	spe➊ci➊aal
speciale	spe➊ci➊a➊le
specifieke	spe➊ci➊fie➊ke
speelde	speel➊de
speelt	speelt
spel	spel
spelen	spe➊len
speler	spe➊ler
spelers	spe➊lers
spijt	spijt
spoor	spoor
sport	sport
sprak	sprak
sprake	spra➊ke
spreekt	spreekt
spreken	spre➊ken
springen	sprin➊gen
spullen	spul➊len
staan	staan
staat	staat
staatsobligaties	staats➊obli➋ga➋ties
staatssecretaris	staats➊se➋cre➊ta➋ris
stabiel	sta➊biel
stad	stad
staking	sta➊king
stand	stand
stap	stap
stappen	stap➊pen
stapt	stapt
stapte	stap➊te
star	star
Star	Star
start	start
staten	sta➊ten
Staten	Sta➊ten
station	sta➊ti➊on
statistiek	sta➊tis➊tiek
statistiekbureau	sta➋tis➋tiek➊bu➋reau
status	sta➊tus
steden	ste➊den
steeds	steeds
steeg	steeg
stegen	ste➊gen
steken	ste➊ken
stel	stel
stelde	stel➊de
stellen	stel➊len
stelling	stel➊ling
stelt	stelt
stem	stem
stemmen	stem➊men
stemming	stem➊ming
stemrecht	stem➊recht
ster	ster
sterk	sterk
sterke	ster➊ke
sterker	ster➊ker
sterkste	sterk➊ste
sterren	ster➊ren
steun	steun
steunen	steu➊nen
stevig	ste➊vig
stevige	ste➊vi➊ge
stichting	stich➊ting
stijgen	stij➊gen
stijgende	stij➊gen➊de
stijging	stij➊ging
stijgt	stijgt
stil	stil
stimuleren	sti➊mu➊le➊ren
stond	stond
stonden	ston➊den
stop	stop
stoppen	stop➊pen
stopt	stopt
storm	storm
straat	straat
straf	straf
straks	straks
strand	strand
strategie	stra➊te➊gie
streep	streep
street	street
Street	Street
strijd	strijd
stroom	stroom
studenten	stu➊den➊ten
studie	stu➊die
studio	stu➊dio
stuk	stuk
stukken	stuk➊ken
sturen	stu➊ren
stuur	stuur
succes	suc➊ces
succesvol	suc➊ces➊vol
succesvolle	suc➊ces➊vol➊le
supermarkten	su➊per➊mark➊ten
Swift	Swift
SWIFT	SWIFT
Sydney	Syd➊ney
Sylvie	Syl➊vie
Syrië	Sy➊rië
Syrische	Sy➊ri➊sche
systeem	sys➊teem
tafel	ta➊fel
tak	tak
talent	ta➊lent
tarieven	ta➊rie➊ven
Taylor	Tay➊lor
team	team
technisch	tech➊nisch
technische	tech➊ni➊sche
technologie	tech➊no➊lo➊gie
Teeven	Tee➊ven
tegelijkertijd	te➊ge➊lij➊ker➊tijd
tegemoet	te➊ge➊moet
tegen	te➊gen
tegenover	te➋gen➊over
tegenstanders	te➋gen➊stan➋ders
tegenvallende	te➋gen➊val➋len➋de
tegenwoordig	te➋gen➊woor➋dig
teken	te➊ken
tekenen	te➊ke➊nen
tekort	te➊kort
tekst	tekst
telecombedrijf	te➋le➋com➊be➋drijf
telefoon	te➋le➊foon
telegraaf	te➋le➊graaf
teleurgesteld	te➊leur➊ge➊steld
televisie	te➋le➊vi➋sie
telt	telt
tempo	tem➊po
ten	ten
ter	ter
terecht	te➊recht
termijn	ter➊mijn
terrein	ter➊rein
terug	te➊rug
terugval	te➋rug➊val
terwijl	ter➊wijl
test	test
tevens	te➊vens
tevreden	te➊vre➊den
the	the
theater	the➊a➊ter
Theodoor	The➊o➊door
Thomas	Tho➊mas
thuis	thuis
tien	tien
tientallen	tien➊tal➊len
tijd	tijd
tijdelijk	tij➋de➊lijk
tijdelijke	tij➋de➊lij➋ke
tijden	tij➊den
tijdens	tij➊dens
tijdje	tijd➊je
tijdschrift	tijd➊schrift
Tilburg	Til➊burg
Tim	Tim
time	time
Time	Time
times	times
Times	Times
Timmermans	Tim➋mer➊mans
tips	tips
titel	ti➊tel
TMZ	TMZ
TNT	TNT
toch	toch
toe	toe
toegang	toe➊gang
toegenomen	toe➊ge➋no➋men
toekomst	toe➊komst
toekomstige	toe➊kom➋sti➋ge
toelichting	toe➊lich➋ting
toen	toen
toename	toe➊na➋me
toenemen	toe➊ne➋men
toenemende	toe➊ne➋men➊de
toeristen	toe➊ris➊ten
toespraak	toe➊spraak
toestand	toe➊stand
toestel	toe➊stel
toestellen	toe➊stel➋len
toestemming	toe➊stem➋ming
toezicht	toe➊zicht
toezichthouder	toe➊zicht➊hou➋der
toezichthouders	toe➊zicht➊hou➋ders
Tokio	To➊kio
Tom	Tom
TomTom	Tom➊Tom
ton	ton
tonen	to➊nen
toont	toont
top	top
topman	top➊man
tot	tot
totaal	to➊taal
totale	to➊ta➊le
totdat	tot➊dat
tour	tour
Tour	Tour
traditionele	tra➊di➊ti➊o➊ne➊le
trainer	trai➊ner
transactie	trans➊ac➋tie
transacties	trans➊ac➋ties
treden	tre➊den
treedt	treedt
trein	trein
treinen	trei➊nen
trek	trek
trekken	trek➊ken
trekt	trekt
trend	trend
trok	trok
trots	trots
trouwen	trou➊wen
Trump	Trump
Turkije	Tur➊kije
Turkse	Turk➊se
tussen	tus➊sen
tussentijds	tus➋sen➊tijds
twaalf	twaalf
twee	twee
tweede	twee➊de
tweeling	twee➊ling
Twente	Twen➊te
twintig	twin➊tig
Twitter	Twit➊ter
type	ty➊pe
UBS	UBS
uit	uit
uitbreiding	uit➊brei➋ding
uiteindelijk	uit➊ein➋de➋lijk
uiteraard	ui➋ter➊aard
uiterlijk	ui➋ter➊lijk
uitgaven	uit➊ga➊ven
uitgebreid	uit➊ge➋breid
uitgegeven	uit➊ge➋ge➋ven
uitgesteld	uit➊ge➋steld
uitgever	uit➊ge➋ver
uitgevoerd	uit➊ge➋voerd
uitgezonden	uit➊ge➋zon➋den
uitkering	uit➊ke➋ring
uitkomen	uit➊ko➋men
uitkomst	uit➊komst
uitkomt	uit➊komt
uitslag	uit➊slag
uitspraak	uit➊spraak
uitspraken	uit➊spra➋ken
uitstel	uit➊stel
uitvoeren	uit➊voe➋ren
uitzending	uit➊zen➋ding
undefined	un➊de➋fi➋ned
unie	unie
Unilever	Uni➊le➋ver
United	Uni➊ted
universiteit	uni➊ver➊si➊teit
uren	uren
Utrecht	Utrecht
uur	uur
UWV	UWV
vaak	vaak
vader	va➊der
vakantie	va➊kan➊tie
vakbond	vak➊bond
vakbonden	vak➊bon➊den
vaker	va➊ker
val	val
vallen	val➊len
valt	valt
valuta	va➊lu➊ta
van	van
vanaf	van➊af
vanavond	van➊avond
vandaag	van➊daag
vanochtend	van➊och➊tend
vanuit	van➊uit
vanwege	van➊we➊ge
varen	va➊ren
vast	vast
vaste	vas➊te
vastgelegd	vast➊ge➋legd
vastgesteld	vast➊ge➋steld
vastgoed	vast➊goed
vat	vat
vaten	va➊ten
VEB	VEB
veel	veel
veelal	veel➊al
veertig	veer➊tig
Vegas	Ve➊gas
veilig	vei➊lig
veilige	vei➊li➊ge
veiligheid	vei➋lig➊heid
veiling	vei➊ling
veld	veld
vele	ve➊le
velen	ve➊len
ver	ver
veranderd	ver➊an➋derd
veranderen	ver➊an➋de➋ren
verandering	ver➊an➋de➋ring
verandert	ver➊an➊dert
verantwoordelijk	ver➊ant➊woor➊de➊lijk
verantwoordelijkheid	ver➊ant➊woor➊de➊lijk➊heid
verband	ver➊band
verbeterd	ver➊be➊terd
verbeterde	ver➊be➊ter➊de
verbeteren	ver➊be➊te➊ren
verbetering	ver➊be➊te➊ring
verbod	ver➊bod
verboden	ver➊bo➋den
verbonden	ver➊bon➋den
verdacht	ver➊dacht
verdachte	ver➊dach➋te
verdachten	ver➊dach➋ten
verdeeld	ver➊deeld
verder	ver➊der
verdere	ver➊de➋re
verdienen	ver➊die➊nen
verdient	ver➊dient
verdwenen	ver➊dwe➊nen
verdwijnen	ver➊dwij➊nen
verenigd	ver➊e➊nigd
Verenigd	Ver➊e➊nigd
verenigde	ver➊e➊nig➊de
Verenigde	Ver➊e➊nig➊de
vereniging	ver➊e➊ni➊ging
Vereniging	Ver➊e➊ni➊ging
vergadering	ver➊ga➊de➊ring
vergeleken	ver➊ge➊le➊ken
vergelijkbare	ver➊ge➊lijk➊ba➊re
vergelijking	ver➊ge➊lij➊king
vergeten	ver➊ge➊ten
vergoeding	ver➊goe➊ding
vergroot	ver➊groot
verhaal	ver➊haal
verhalen	ver➊ha➊len
verhogen	ver➊ho➊gen
verhoging	ver➊ho➊ging
verhoogd	ver➊hoogd
verhoogde	ver➊hoog➊de
verjaardag	ver➊jaar➊dag
verkeer	ver➊keer
verkeerd	ver➊keerd
verkeerde	ver➊keer➊de
verkiezingen	ver➊kie➊zin➊gen
verklaard	ver➊klaard
verklaarde	ver➊klaar➊de
verklaring	ver➊kla➊ring
verkocht	ver➊kocht
verkoop	ver➊koop
verkoopt	ver➊koopt
verkopen	ver➊ko➊pen
verlaagd	ver➊laagd
verlaagde	ver➊laag➊de
verlagen	ver➊la➊gen
verlaging	ver➊la➊ging
verlaten	ver➊la➊ten
verleden	ver➊le➊den
verliefd	ver➊liefd
verlies	ver➊lies
verliest	ver➊liest
verliezen	ver➊lie➊zen
verloofde	ver➊loof➊de
verloor	ver➊loor
verlopen	ver➊lo➊pen
verloren	ver➊lo➊ren
verluidt	ver➊luidt
vermeende	ver➊meen➊de
vermoedelijk	ver➊moe➊de➊lijk
vermogen	ver➊mo➊gen
vermogensbeheerder	ver➊mo➊gens➊be➊heer➊der
veroordeeld	ver➊oor➊deeld
veroorzaakt	ver➊oor➊zaakt
verplicht	ver➊plicht
verrassing	ver➊ras➊sing
verrast	ver➊rast
verre	ver➊re
Verre	Ver➊re
verscheen	ver➊scheen
verschenen	ver➊sche➊nen
verschijnen	ver➊schij➊nen
verschijnt	ver➊schijnt
verschil	ver➊schil
verschillen	ver➊schil➊len
verschillende	ver➊schil➊len➊de
versie	ver➊sie
verstandig	ver➊stan➊dig
versterken	ver➊ster➊ken
vertelde	ver➊tel➊de
vertellen	ver➊tel➊len
vertelt	ver➊telt
vertraging	ver➊tra➊ging
vertrek	ver➊trek
vertrekken	ver➊trek➊ken
vertrouwen	ver➊trou➊wen
vervangen	ver➊van➊gen
vervoer	ver➊voer
vervolg	ver➊volg
vervolgens	ver➊vol➊gens
vervolgt	ver➊volgt
verwacht	ver➊wacht
verwachte	ver➊wach➊te
verwachten	ver➊wach➊ten
verwachting	ver➊wach➊ting
verwachtingen	ver➊wach➊tin➊gen
verwerken	ver➊wer➊ken
verwijderd	ver➊wij➊derd
verwondingen	ver➊won➊din➊gen
verzekeraar	ver➊ze➊ke➊raar
verzekeraars	ver➊ze➊ke➊raars
verzoek	ver➊zoek
vestigingen	ves➊ti➊gin➊gen
via	via
Victoria	Vic➊to➊ria
VICTORIA	VIC➊TO➊RIA
video	vi➊deo
viel	viel
vielen	vie➊len
vier	vier
vierde	vier➊de
vieren	vie➊ren
vierkante	vier➊kan➊te
viert	viert
vijf	vijf
vijfde	vijf➊de
vijftien	vijf➊tien
vijftig	vijf➊tig
villa	vil➊la
vind	vind
vinden	vin➊den
vindt	vindt
visie	vi➊sie
vlak	vlak
vlees	vlees
vliegen	vlie➊gen
vliegtuig	vlieg➊tuig
vliegtuigen	vlieg➊tui➋gen
vliegveld	vlieg➊veld
vlucht	vlucht
vluchtelingen	vluch➊te➊lin➊gen
vluchten	vluch➊ten
voedsel	voed➊sel
voel	voel
voelde	voel➊de
voelen	voe➊len
voelt	voelt
voeren	voe➊ren
voert	voert
voet	voet
voetbal	voet➊bal
voetballer	voet➊bal➊ler
voeten	voe➊ten
voice	voi➊ce
Voice	Voi➊ce
vol	vol
volatiliteit	vo➊la➊ti➊li➊teit
voldoen	vol➊doen
voldoende	vol➊doen➊de
volg	volg
Volg	Volg
volgde	volg➊de
volgen	vol➊gen
volgend	vol➊gend
volgende	vol➊gen➊de
volgens	vol➊gens
Volgens	Vol➊gens
volgers	vol➊gers
volgt	volgt
Volkswagen	Volks➊wa➋gen
volle	vol➊le
volledig	vol➊le➊dig
volledige	vol➊le➊di➊ge
volop	vol➊op
vond	vond
vonden	von➊den
voor	voor
vooraf	voor➊af
vooral	voor➊al
vooralsnog	voor➊als➊nog
voorbeeld	voor➊beeld
voorbeurs	voor➊beurs
voorbij	voor➊bij
voordat	voor➊dat
voordeel	voor➊deel
voorgaande	voor➊gaan➊de
voorheen	voor➊heen
voorjaar	voor➊jaar
voorkeur	voor➊keur
voorkomen	voor➊ko➊men
voorlopig	voor➊lo➊pig
voorlopige	voor➊lo➊pi➊ge
voormalig	voor➊ma➋lig
voormalige	voor➊ma➋li➋ge
voornamelijk	voor➊na➋me➊lijk
voorspeld	voor➊speld
voorstel	voor➊stel
voorstellen	voor➊stel➊len
voort	voort
voortaan	voort➊aan
vooruit	voor➊uit
vooruitgang	voor➊uit➊gang
vooruitzichten	voor➊uit➊zich➋ten
voorwaarden	voor➊waar➋den
voorzichtig	voor➊zich➋tig
voorzien	voor➊zien
voorziet	voor➊ziet
voorzitter	voor➊zit➋ter
Vopak	Vopak
voren	vo➊ren
vorig	vo➊rig
vorige	vo➊ri➊ge
vorm	vorm
vormen	vor➊men
vormt	vormt
vraag	vraag
vraagt	vraagt
vragen	vra➊gen
vreemd	vreemd
vrees	vrees
vreest	vreest
vrezen	vre➊zen
vriend	vriend
vrienden	vrien➊den
vriendin	vrien➊din
vries	vries
vrij	vrij
vrijdag	vrij➊dag
vrijdagavond	vrij➋dag➊avond
vrije	vrije
vrijheid	vrij➊heid
vrijwel	vrij➊wel
vroeg	vroeg
vroeger	vroe➊ger
vrouw	vrouw
vrouwelijke	vrou➊we➋lij➋ke
vrouwen	vrou➊wen
vuur	vuur
vuurwerk	vuur➊werk
VVD	VVD
waar	waar
waarbij	waar➊bij
waard	waard
waarde	waar➊de
waarden	waar➊den
waardering	waar➊de➊ring
waardoor	waar➊door
waarin	waar➊in
waarmee	waar➊mee
waarna	waar➊na
waarom	waar➊om
waaronder	waar➊on➊der
waarop	waar➊op
waarschijnlijk	waar➊schijn➊lijk
waarschuwde	waar➊schuw➊de
waarschuwt	waar➊schuwt
waarvan	waar➊van
waarvoor	waar➊voor
wacht	wacht
wachten	wach➊ten
wakker	wak➊ker
wall	wall
Wall	Wall
wanneer	wan➊neer
want	want
wapens	wa➊pens
ware	wa➊re
waren	wa➊ren
warm	warm
was	was
Washington	Wa➊shing➊ton
wat	wat
water	wa➊ter
wederom	we➊der➊om
wedstrijd	wed➊strijd
wedstrijden	wed➊strij➊den
week	week
weekeinde	week➊ein➊de
weekend	week➊end
weer	weer
weerstand	weer➊stand
wees	wees
weet	weet
weg	weg
wegen	we➊gen
wegens	we➊gens
weinig	wei➊nig
weken	we➊ken
wel	wel
wél	wél
weliswaar	wel➊is➊waar
welk	welk
welke	wel➊ke
welkom	wel➊kom
wellicht	wel➊licht
wens	wens
wensen	wen➊sen
werd	werd
werden	wer➊den
wereld	we➊reld
wereldeconomie	we➋reld➊eco➋no➋mie
werelds	we➊relds
wereldwijd	we➋reld➊wijd
wereldwijde	we➋reld➊wij➋de
werk	werk
werken	wer➊ken
werkgelegenheid	werk➊ge➋le➋gen➋heid
werkgever	werk➊ge➋ver
werkgevers	werk➊ge➋vers
werkloosheid	werk➊loos➊heid
werknemer	werk➊ne➋mer
werknemers	werk➊ne➋mers
werkt	werkt
werkte	werk➊te
werkzaamheden	werk➊zaam➊he➋den
west	west
West	West
westen	wes➊ten
westerse	wes➊ter➊se
wet	wet
weten	we➊ten
wethouder	wet➊hou➋der
wie	wie
wij	wij
wijk	wijk
wijst	wijst
wijze	wij➊ze
wijzen	wij➊zen
wil	wil
wilde	wil➊de
wilden	wil➊den
Wilders	Wil➊ders
Willem	Wil➊lem
willen	wil➊len
William	Wil➊li➊am
Williams	Wil➊li➊ams
wilt	wilt
wind	wind
winkel	win➊kel
winkels	win➊kels
winnaar	win➊naar
winnen	win➊nen
winst	winst
winsten	win➊sten
winstgevendheid	winst➊ge➊vend➊heid
wint	wint
winter	win➊ter
wisselkoerseffecten	wis➋sel➊koers➊ef➋fec➋ten
wist	wist
wisten	wis➊ten
wit	wit
witte	wit➊te
woensdag	woens➊dag
woensdagavond	woens➋dag➊avond
won	won
wonen	wo➊nen
woning	wo➊ning
woningen	wo➊nin➊gen
woningmarkt	wo➋ning➊markt
woont	woont
woord	woord
woorden	woor➊den
woordvoerder	woord➊voer➋der
woordvoerster	woord➊voer➋ster
word	word
worden	wor➊den
wordt	wordt
world	world
World	World
Yellen	Yel➊len
yen	yen
Yolanthe	Yo➊lan➊the
York	York
zaak	zaak
zag	zag
zagen	za➊gen
zakelijke	za➊ke➊lij➊ke
zaken	za➊ken
zakte	zak➊te
zal	zal
zanger	zan➊ger
zangeres	zan➊ge➊res
zat	zat
zaten	za➊ten
zaterdag	za➊ter➊dag
zaterdagavond	za➊ter➊dag➊avond
zee	zee
Zeeland	Zee➊land
zeer	zeer
zeg	zeg
zeggen	zeg➊gen
zegsman	zegs➊man
zegt	zegt
zei	zei
zeker	ze➊ker
zekerheid	ze➊ker➊heid
zelf	zelf
zelfmoord	zelf➊moord
zelfs	zelfs
zelfstandig	zelf➊stan➋dig
zender	zen➊der
zes	zes
zet	zet
zette	zet➊te
zetten	zet➊ten
zeven	ze➊ven
zich	zich
zicht	zicht
zichtbaar	zicht➊baar
zichzelf	zich➊zelf
zie	zie
ziek	ziek
ziekenhuis	zie➋ken➊huis
ziekenhuizen	zie➋ken➊hui➋zen
ziekte	ziek➊te
zien	zien
ziet	ziet
Ziggo	Zig➊go
zij	zij
zijn	zijn
zilver	zil➊ver
zin	zin
zingen	zin➊gen
zit	zit
zitten	zit➊ten
zoals	zo➊als
zodat	zo➊dat
zodra	zo➊dra
zoek	zoek
zoeken	zoe➊ken
zoekt	zoekt
zoektocht	zoek➊tocht
zogeheten	zo➊ge➊he➊ten
zogenaamde	zo➊ge➊naam➊de
zogenoemde	zo➊ge➊noem➊de
zolang	zo➊lang
zomaar	zo➊maar
zomer	zo➊mer
zon	zon
zondag	zon➊dag
zondagavond	zon➋dag➊avond
zonder	zon➊der
zoon	zoon
zoontje	zoon➊tje
zorg	zorg
zorgde	zorg➊de
zorgen	zor➊gen
zorgt	zorgt
zou	zou
zouden	zou➊den
zoveel	zo➊veel
zover	zo➊ver
zowel	zo➊wel
zuid	zuid
zuiden	zui➊den
zullen	zul➊len
zus	zus
zwaar	zwaar
zwakke	zwak➊ke
zwanger	zwan➊ger
zwangerschap	zwan➋ger➊schap
zware	zwa➊re
zwart	zwart
zwarte	zwar➊te
Zweden	Zwe➊den
Zweedse	Zweed➊se
Zwitserland	Zwit➋ser➊land
Zwitserse	Zwit➋ser➊se
