Form	Hyphenation

# SPDX-License-Identifier: Unicode-DFS-2016

absolutnie	ab➊so➊lut➊nie
aby	aby
administracji	ad➊mi➊ni➊stra➊cji
adresem	ad➊re➊sem
afd	afd
AfD	AfD
AFD	AFD
afera	afe➊ra
afery	afe➊ry
Afganistanie	Af➊ga➊ni➊sta➊nie
Afganistanu	Af➊ga➊ni➊sta➊nu
Afryce	Afry➊ce
Afryki	Afry➊ki
agencja	agen➊cja
Agencja	Agen➊cja
agencji	agen➊cji
Agnieszka	Ag➊nie➊szka
akcja	ak➊cja
akcje	ak➊cje
akcji	ak➊cji
akt	akt
aktualnie	ak➊tu➊al➊nie
akurat	aku➊rat
alarm	alarm
albo	al➊bo
ale	ale
Alexandra	Ale➊xan➊dra
alternatywy	al➊ter➊na➊ty➊wy
ambasador	am➊ba➊sa➊dor
Amerykanie	Ame➊ry➊ka➊nie
Amerykanów	Ame➊ry➊ka➊nów
amerykański	ame➊ry➊kań➊ski
amerykańskich	ame➊ry➊kań➊skich
amerykańskiego	ame➊ry➊kań➊skie➊go
amerykańskiej	ame➊ry➊kań➊skiej
Ameryki	Ame➊ry➊ki
analizuje	ana➊li➊zu➊je
analizy	ana➊li➊zy
Andreas	An➊dre➊as
Andrzej	An➊drzej
Andrzeja	An➊drze➊ja
Angela	An➊ge➊la
Angelę	An➊ge➊lę
Angeli	An➊ge➊li
ani	ani
ankietowanych	an➊kie➊to➊wa➊nych
ankiety	an➊kie➊ty
Anna	An➊na
apel	apel
apeluje	ape➊lu➊je
ARD	ARD
armia	ar➊mia
armii	ar➊mii
artykule	ar➊ty➊ku➊le
artykuł	ar➊ty➊kuł
artykułu	ar➊ty➊ku➊łu
artystów	ar➊ty➊stów
atak	atak
ataki	ata➊ki
ataków	ata➊ków
ataku	ata➊ku
atomowego	ato➊mo➊we➊go
atomowej	ato➊mo➊wej
atomowych	ato➊mo➊wych
Auschwitz	Au➊schwitz
Austrii	Au➊strii
autor	au➊tor
autora	au➊to➊ra
autorka	au➊tor➊ka
autorów	au➊to➊rów
autorzy	au➊to➊rzy
Azji	Azji
azyl	azyl
badania	ba➊da➊nia
badań	ba➊dań
Badenii	Ba➊de➊nii
bank	bank
Bank	Bank
banki	ban➊ki
banks	banks
banku	ban➊ku
Barack	Ba➊rack
Barbara	Bar➊ba➊ra
bardziej	bar➊dziej
bardzo	bar➊dzo
Barroso	Bar➊ro➊so
Bartosz	Bar➊tosz
Bawarii	Ba➊wa➊rii
bądź	bądź
Benedykt	Be➊ne➊dykt
Benedykta	Be➊ne➊dyk➊ta
Berlin	Ber➊lin
Berlina	Ber➊li➊na
Berlinale	Ber➊li➊na➊le
Berlinem	Ber➊li➊nem
Berliner	Ber➊li➊ner
Berlinie	Ber➊li➊nie
berlińska	ber➊liń➊ska
berliński	ber➊liń➊ski
berlińskiego	ber➊liń➊skie➊go
berlińskiej	ber➊liń➊skiej
berlińskim	ber➊liń➊skim
bez	bez
bezpieczeństwa	bez➊pie➊czeń➊stwa
bezpieczeństwo	bez➊pie➊czeń➊stwo
bezpośrednio	bez➊po➊śre➊dnio
bezrobocia	bez➊ro➊bo➊cia
bezrobocie	bez➊ro➊bo➊cie
bezrobotnych	bez➊ro➊bot➊nych
będą	bę➊dą
będzie	bę➊dzie
będziemy	bę➊dzie➊my
Białorusi	Bia➊ło➊ru➊si
bierze	bie➊rze
bilans	bi➊lans
biskup	bi➊skup
biura	biu➊ra
bliskim	bli➊skim
Bliskim	Bli➊skim
blisko	bli➊sko
bliżej	bli➊żej
błąd	błąd
błędów	błę➊dów
błędy	błę➊dy
BND	BND
Bochum	Bo➊chum
Bonn	Bonn
bowiem	bo➊wiem
brak	brak
braku	bra➊ku
brakuje	bra➊ku➊je
Brandenburgii	Bran➊den➊bur➊gii
branża	bran➊ża
branży	bran➊ży
broni	bro➊ni
bronią	bro➊nią
bronić	bro➊nić
broń	broń
Bruksela	Bruk➊se➊la
Brukseli	Bruk➊se➊li
Brytania	Bry➊ta➊nia
Brytanii	Bry➊ta➊nii
brzmi	brzmi
budowę	bu➊do➊wę
budowy	bu➊do➊wy
budzi	bu➊dzi
budżet	bu➊dżet
budżetu	bu➊dże➊tu
Bułgarii	Buł➊ga➊rii
Bundestag	Bun➊de➊stag
Bundeswehra	Bun➊de➊sweh➊ra
Bundeswehry	Bun➊de➊sweh➊ry
burmistrz	bur➊mistrz
Bush	Bush
Busha	Bu➊sha
być	być
byli	by➊li
był	był
była	by➊ła
byłaby	by➊ła➊by
byłby	był➊by
byłego	by➊łe➊go
byłej	by➊łej
było	by➊ło
byłoby	by➊ło➊by
były	by➊ły
byłyby	by➊ły➊by
byłych	by➊łych
cała	ca➊ła
całą	ca➊łą
całe	ca➊łe
całego	ca➊łe➊go
całej	ca➊łej
całkiem	cał➊kiem
całkowicie	cał➊ko➊wi➊cie
cały	ca➊ły
całych	ca➊łych
całym	ca➊łym
CDU	CDU
cel	cel
cele	ce➊le
celem	ce➊lem
celów	ce➊lów
celu	ce➊lu
cen	cen
cena	ce➊na
cenę	ce➊nę
centrum	cen➊trum
ceny	ce➊ny
chadecji	cha➊de➊cji
chadecy	cha➊de➊cy
chadeków	cha➊de➊ków
charakter	cha➊rak➊ter
chcą	chcą
chce	chce
chcemy	chce➊my
chciał	chciał
chciała	chcia➊ła
chcieli	chcie➊li
chętnie	chę➊tnie
Chin	Chin
Chinach	Chi➊nach
Chiny	Chi➊ny
chociaż	cho➊ciaż
choć	choć
choćby	choć➊by
chodzi	cho➊dzi
chodziło	cho➊dzi➊ło
choroby	cho➊ro➊by
Christian	Chri➊stian
chronić	chro➊nić
chwili	chwi➊li
chyba	chy➊ba
cia	cia
CIA	CIA
ciągle	cią➊gle
ciągu	cią➊gu
cieszą	cie➊szą
cieszy	cie➊szy
ciężko	cięż➊ko
codziennie	co➊dzien➊nie
codzoziemców	co➊dzo➊ziem➊ców
coraz	co➊raz
coś	coś
CSU	CSU
cytuje	cy➊tu➊je
czarno	czar➊no
czas	czas
czasach	cza➊sach
czasami	cza➊sa➊mi
czasem	cza➊sem
czasie	cza➊sie
czasów	cza➊sów
czasu	cza➊su
czasy	cza➊sy
Czech	Czech
czego	cze➊go
czegos	cze➊gos
czegoś	cze➊goś
czeka	cze➊ka
czele	cze➊le
czerwca	czerw➊ca
czerwcu	czerw➊cu
często	czę➊sto
części	czę➊ści
częścią	czę➊ścią
częściej	czę➊ściej
częściowo	czę➊ścio➊wo
członek	czło➊nek
członkiem	człon➊kiem
członkostwa	człon➊ko➊stwa
członkowie	człon➊ko➊wie
członkowskich	człon➊kow➊skich
członkowskie	człon➊kow➊skie
członków	człon➊ków
człowiek	czło➊wiek
człowieka	czło➊wie➊ka
czołowych	czo➊ło➊wych
czterech	czte➊rech
cztery	czte➊ry
czują	czu➊ją
czuje	czu➊je
czwartek	czwar➊tek
czy	czy
czyli	czy➊li
czym	czym
czyms	czyms
czymś	czymś
czyn	czyn
czynienia	czy➊nie➊nia
czytamy	czy➊ta➊my
dać	dać
daje	da➊je
dalej	da➊lej
daleko	da➊le➊ko
dalsze	dal➊sze
dalszego	dal➊sze➊go
dalszej	dal➊szej
dalszy	dal➊szy
dalszych	dal➊szych
dalszym	dal➊szym
dał	dał
dane	da➊ne
danych	da➊nych
dawna	daw➊na
dawno	daw➊no
debacie	de➊ba➊cie
debata	de➊ba➊ta
debatę	de➊ba➊tę
debaty	de➊ba➊ty
decyzja	de➊cy➊zja
decyzje	de➊cy➊zje
decyzji	de➊cy➊zji
deficyt	de➊fi➊cyt
demokracja	de➊mo➊kra➊cja
demokracji	de➊mo➊kra➊cji
demokratów	de➊mo➊kra➊tów
demokratycznych	de➊mo➊kra➊tycz➊nych
demonstracji	de➊mon➊stra➊cji
demonstrantów	de➊mon➊stran➊tów
dialog	dia➊log
dialogu	dia➊lo➊gu
dla	dla
dlaczego	dla➊cze➊go
dlatego	dla➊te➊go
Dlatego	Dla➊te➊go
długo	dłu➊go
długów	dłu➊gów
dłużej	dłu➊żej
dłuższą	dłuż➊szą
dni	dni
dnia	dnia
dniach	dniach
dniem	dniem
dniu	dniu
dobra	do➊bra
dobrą	do➊brą
dobre	do➊bre
dobrego	do➊bre➊go
dobrej	do➊brej
dobry	do➊bry
dobrych	do➊brych
dobrym	do➊brym
dobrze	do➊brze
dochodów	do➊cho➊dów
dochodzi	do➊cho➊dzi
dodając	do➊da➊jąc
dodaje	do➊da➊je
dodał	do➊dał
dodała	do➊da➊ła
dodatkowe	do➊dat➊ko➊we
dodatkowo	do➊dat➊ko➊wo
dodatkowych	do➊dat➊ko➊wych
dojdzie	doj➊dzie
dokładnie	do➊kład➊nie
dokument	do➊ku➊ment
dokumentów	do➊ku➊men➊tów
dokumenty	do➊ku➊men➊ty
dolarów	do➊la➊rów
dolnej	dol➊nej
Dolnej	Dol➊nej
dom	dom
domaga	do➊ma➊ga
domagają	do➊ma➊ga➊ją
domów	do➊mów
domu	do➊mu
Donald	Do➊nald
Donalda	Do➊nal➊da
doniesienia	do➊nie➊sie➊nia
doniesień	do➊nie➊sień
donosi	do➊no➊si
dopiero	do➊pie➊ro
doprowadzić	do➊pro➊wa➊dzić
dostaw	do➊staw
dostawy	do➊sta➊wy
dostęp	do➊stęp
dostrzega	do➊strze➊ga
doszło	do➊szło
dość	dość
doświadczenia	do➊świad➊cze➊nia
dotąd	do➊tąd
dotychczas	do➊tych➊czas
dotyczące	do➊ty➊czą➊ce
dotyczących	do➊ty➊czą➊cych
dotyczy	do➊ty➊czy
dpa	dpa
Dreźnie	Dreź➊nie
drodze	dro➊dze
droga	dro➊ga
drogą	dro➊gą
drogę	dro➊gę
drogi	dro➊gi
dróg	dróg
druga	dru➊ga
drugą	dru➊gą
drugi	dru➊gi
drugie	dru➊gie
drugiego	dru➊gie➊go
drugiej	dru➊giej
drugim	dru➊gim
drzwi	drzwi
duchu	du➊chu
Dudek	Du➊dek
Dusseldorfie	Dus➊sel➊dor➊fie
dużą	du➊żą
duże	du➊że
dużej	du➊żej
dużo	du➊żo
duży	du➊ży
dużych	du➊żych
dużym	du➊żym
dwa	dwa
dwie	dwie
dwoma	dwo➊ma
dwóch	dwóch
dymisji	dy➊mi➊sji
dyplomacji	dy➊plo➊ma➊cji
dyrektor	dy➊rek➊tor
dyskusja	dys➊ku➊sja
dyskusję	dys➊ku➊sję
dyskusji	dys➊ku➊sji
działa	dzia➊ła
działać	dzia➊łać
działalności	dzia➊łal➊no➊ści
działalność	dzia➊łal➊ność
działania	dzia➊ła➊nia
działanie	dzia➊ła➊nie
działań	dzia➊łań
dzieci	dzie➊ci
dziecka	dziec➊ka
dziecko	dziec➊ko
dziećmi	dzieć➊mi
dziedzinie	dzie➊dzi➊nie
dzieje	dzie➊je
dzielnicy	dziel➊ni➊cy
dzieł	dzieł
dzieła	dzie➊ła
dziennik	dzien➊nik
dziennika	dzien➊ni➊ka
dziennikarz	dzien➊ni➊karz
dziennikarze	dzien➊ni➊ka➊rze
dziennikarzy	dzien➊ni➊ka➊rzy
dzienniki	dzien➊ni➊ki
dzień	dzień
dziesiątki	dzie➊siąt➊ki
dziesięciu	dzie➊się➊ciu
dziesięć	dzie➊sięć
dzięki	dzię➊ki
dzisiaj	dzi➊siaj
dzisiejszej	dzi➊siej➊szej
dzisiejszych	dzi➊siej➊szych
dzisiejszym	dzi➊siej➊szym
dziś	dziś
EBC	EBC
edukacji	edu➊ka➊cji
efekt	efekt
ekspert	eks➊pert
ekspertów	eks➊per➊tów
eksport	eks➊port
eksportu	eks➊por➊tu
Elżbieta	Elż➊bie➊ta
emisji	emi➊sji
energetycznej	ener➊ge➊tycz➊nej
energetyki	ener➊ge➊ty➊ki
energię	ener➊gię
energii	ener➊gii
Erdogan	Er➊do➊gan
Erdogana	Er➊do➊ga➊na
Erika	Eri➊ka
Eriki	Eri➊ki
Essen	Es➊sen
euro	eu➊ro
europa	eu➊ro➊pa
Europa	Eu➊ro➊pa
Europą	Eu➊ro➊pą
Europejczycy	Eu➊ro➊pej➊czy➊cy
europejczyków	eu➊ro➊pej➊czy➊ków
Europejczyków	Eu➊ro➊pej➊czy➊ków
europejska	eu➊ro➊pej➊ska
Europejska	Eu➊ro➊pej➊ska
europejską	eu➊ro➊pej➊ską
Europejską	Eu➊ro➊pej➊ską
europejski	eu➊ro➊pej➊ski
Europejski	Eu➊ro➊pej➊ski
europejskich	eu➊ro➊pej➊skich
europejskie	eu➊ro➊pej➊skie
europejskiego	eu➊ro➊pej➊skie➊go
Europejskiego	Eu➊ro➊pej➊skie➊go
europejskiej	eu➊ro➊pej➊skiej
Europejskiej	Eu➊ro➊pej➊skiej
europejskim	eu➊ro➊pej➊skim
Europę	Eu➊ro➊pę
Europie	Eu➊ro➊pie
europy	eu➊ro➊py
Europy	Eu➊ro➊py
euros	eu➊ros
Eva	Eva
fachowców	fa➊chow➊ców
fakt	fakt
faktem	fak➊tem
faktu	fak➊tu
fakty	fak➊ty
faktycznie	fak➊ty➊cznie
fala	fa➊la
fali	fa➊li
faz	faz
FAZ	FAZ
fazie	fa➊zie
FDP	FDP
federalna	fe➊de➊ral➊na
Federalna	Fe➊de➊ral➊na
federalnego	fe➊de➊ral➊ne➊go
Federalnego	Fe➊de➊ral➊ne➊go
federalnej	fe➊de➊ral➊nej
Federalnej	Fe➊de➊ral➊nej
federalny	fe➊de➊ral➊ny
Federalny	Fe➊de➊ral➊ny
federalnym	fe➊de➊ral➊nym
festiwal	fe➊sti➊wal
festiwalu	fe➊sti➊wa➊lu
fiasko	fia➊sko
film	film
filmów	fil➊mów
filmu	fil➊mu
filmy	fil➊my
Financial	Fi➊nan➊cial
finansową	fi➊nan➊so➊wą
finansowe	fi➊nan➊so➊we
finansowego	fi➊nan➊so➊we➊go
finansowej	fi➊nan➊so➊wej
finansowy	fi➊nan➊so➊wy
finansowych	fi➊nan➊so➊wych
finansowym	fi➊nan➊so➊wym
finansów	fi➊nan➊sów
firm	firm
firma	fir➊ma
firmy	fir➊my
font	font
formie	for➊mie
forum	fo➊rum
frakcji	frak➊cji
Frakfurcie	Frak➊fur➊cie
Franciszek	Fran➊ci➊szek
Francja	Fran➊cja
Francji	Fran➊cji
francuski	fran➊cus➊ki
frank	frank
Frank	Frank
Frankfurter	Frank➊fur➊ter
Frankfurtu	Frank➊fur➊tu
Franz	Franz
Friedrich	Frie➊drich
fundacja	fun➊da➊cja
Fundacja	Fun➊da➊cja
fundacji	fun➊da➊cji
funkcję	funk➊cję
funkcji	funk➊cji
Gabriel	Ga➊briel
gaz	gaz
gazecie	ga➊ze➊cie
gazet	ga➊zet
gazeta	ga➊ze➊ta
gazety	ga➊ze➊ty
gazociągu	ga➊zo➊cią➊gu
gazu	ga➊zu
gdy	gdy
gdyby	gdy➊by
gdyż	gdyż
gdzie	gdzie
General	Ge➊ne➊ral
generalnego	ge➊ne➊ral➊ne➊go
generalny	ge➊ne➊ral➊ny
Georg	Georg
Gerhard	Ger➊hard
Gerharda	Ger➊har➊da
głęboko	głę➊bo➊ko
głos	głos
głosowania	gło➊so➊wa➊nia
głosów	gło➊sów
głosu	gło➊su
głosy	gło➊sy
głowę	gło➊wę
głowy	gło➊wy
główne	głów➊ne
głównie	głów➊nie
główny	głów➊ny
głównych	głów➊nych
głównym	głów➊nym
godzin	go➊dzin
godzinę	go➊dzi➊nę
godziny	go➊dzi➊ny
gorzej	go➊rzej
gospodarce	go➊spo➊dar➊ce
gospodarcza	go➊spo➊dar➊cza
gospodarczą	go➊spo➊dar➊czą
gospodarcze	go➊spo➊dar➊cze
gospodarczego	go➊spo➊dar➊cze➊go
gospodarczej	go➊spo➊dar➊czej
gospodarczy	go➊spo➊dar➊czy
gospodarczych	go➊spo➊dar➊czych
gospodarczym	go➊spo➊dar➊czym
gospodarka	go➊spo➊dar➊ka
gospodarki	go➊spo➊dar➊ki
gości	go➊ści
gotowa	go➊to➊wa
gotowe	go➊to➊we
gotowość	go➊to➊wość
górę	gó➊rę
góry	gó➊ry
gra	gra
granic	gra➊nic
granicach	gra➊ni➊cach
granicą	gra➊ni➊cą
granice	gra➊ni➊ce
granicę	gra➊ni➊cę
granicy	gra➊ni➊cy
Grecja	Gre➊cja
Grecji	Gre➊cji
gremium	gre➊mium
grę	grę
grozi	gro➊zi
grudnia	grud➊nia
grudniu	grud➊niu
grup	grup
grupa	gru➊pa
grupę	gru➊pę
grupie	gru➊pie
grupy	gru➊py
gry	gry
Guido	Gui➊do
Hamburgu	Ham➊bur➊gu
handel	han➊del
Handelsblatt	Han➊dels➊blatt
handlowej	han➊dlo➊wej
handlu	han➊dlu
Hanowerze	Ha➊no➊we➊rze
Hesji	He➊sji
historia	hi➊sto➊ria
historią	hi➊sto➊rią
historię	hi➊sto➊rię
historii	hi➊sto➊rii
historyczne	hi➊sto➊rycz➊ne
historycznych	hi➊sto➊rycz➊nych
historyk	hi➊sto➊ryk
Hiszpanii	Hisz➊pa➊nii
Hitlera	Hi➊tle➊ra
Holandii	Ho➊lan➊dii
ich	ich
idei	ide➊i
idzie	idzie
III	III
ile	ile
ilość	ilość
imieniu	imie➊niu
imię	imię
imigranci	imi➊gran➊ci
imigrantów	imi➊gran➊tów
inaczej	ina➊czej
informacje	in➊for➊ma➊cje
informację	in➊for➊ma➊cję
informacji	in➊for➊ma➊cji
informuje	in➊for➊mu➊je
inicjatywy	ini➊cja➊ty➊wy
inna	in➊na
inne	in➊ne
innego	in➊ne➊go
innej	in➊nej
inni	in➊ni
inny	in➊ny
innych	in➊nych
innym	in➊nym
innymi	in➊ny➊mi
instytucje	in➊sty➊tu➊cje
instytucji	in➊sty➊tu➊cji
instytut	in➊sty➊tut
Instytut	In➊sty➊tut
instytutu	in➊sty➊tu➊tu
Instytutu	In➊sty➊tu➊tu
integracji	in➊te➊gra➊cji
interesie	in➊te➊re➊sie
interesów	in➊te➊re➊sów
interesy	in➊te➊re➊sy
internecie	in➊ter➊ne➊cie
internetu	in➊ter➊ne➊tu
interwencji	in➊ter➊wen➊cji
inwestorów	in➊we➊sto➊rów
inwestycje	in➊we➊sty➊cje
inwestycji	in➊we➊sty➊cji
Iraku	Ira➊ku
Iran	Iran
Iranu	Ira➊nu
islamistów	isla➊mi➊stów
islamskich	islam➊skich
islamskiego	islam➊skie➊go
Islamskiego	Islam➊skie➊go
islamu	isla➊mu
istnieją	istnie➊ją
istnieje	istnie➊je
Iwona	Iwo➊na
Izrael	Izra➊el
Izraela	Izra➊e➊la
jak	jak
jaka	ja➊ka
jaką	ja➊ką
jakby	jak➊by
jaki	ja➊ki
jakich	ja➊kich
jakie	ja➊kie
jakiej	ja➊kiej
jakies	ja➊kies
jakieś	ja➊kieś
jakim	ja➊kim
jakis	ja➊kis
jakiś	ja➊kiś
jako	ja➊ko
jakoby	ja➊ko➊by
jakości	ja➊ko➊ści
jakość	ja➊kość
Jan	Jan
Jana	Ja➊na
Japonii	Ja➊po➊nii
Jarecka	Ja➊rec➊ka
Jarosław	Ja➊ro➊sław
Jarosława	Ja➊ro➊sła➊wa
jasne	ja➊sne
jasno	ja➊sno
jazdy	jaz➊dy
jądrowej	ją➊dro➊wej
jeden	je➊den
jedna	jed➊na
jednak	jed➊nak
jednakże	jed➊nak➊że
Jednakże	Jed➊nak➊że
jedną	jed➊ną
jednego	jed➊ne➊go
jednej	jed➊nej
jedno	jed➊no
jednocześnie	jed➊no➊cze➊śnie
jedności	jed➊no➊ści
jednym	jed➊nym
jedynie	je➊dy➊nie
jedynym	je➊dy➊nym
jego	je➊go
jej	jej
jesienią	je➊sie➊nią
jest	jest
jestem	je➊stem
jesteśmy	je➊ste➊śmy
jeszcze	jesz➊cze
jeśli	je➊śli
jeżeli	je➊że➊li
język	ję➊zyk
języka	ję➊zy➊ka
Joachim	Jo➊a➊chim
Jorku	Jor➊ku
jutro	ju➊tro
już	już
Kaczyński	Ka➊czyń➊ski
Kaczyńskiego	Ka➊czyń➊skie➊go
kadencji	ka➊den➊cji
kampanii	kam➊pa➊nii
kanclerz	kanc➊lerz
kanclerza	kanc➊le➊rza
kandydat	kan➊dy➊dat
kandydata	kan➊dy➊da➊ta
kandydatów	kan➊dy➊da➊tów
kardynał	kar➊dy➊nał
kariery	ka➊rie➊ry
kary	ka➊ry
kasy	ka➊sy
katastrofa	ka➊ta➊stro➊fa
katastrofie	ka➊ta➊stro➊fie
katastrofy	ka➊ta➊stro➊fy
katolicki	ka➊to➊lic➊ki
katolickiego	ka➊to➊lic➊kie➊go
każda	każ➊da
każde	każ➊de
każdego	każ➊de➊go
każdej	każ➊dej
każdy	każ➊dy
każdym	każ➊dym
kibiców	ki➊bi➊ców
kiedy	kie➊dy
kiedys	kie➊dys
kiedyś	kie➊dyś
kierowców	kie➊row➊ców
kierownictwo	kie➊row➊nic➊two
kierunku	kie➊run➊ku
Kijowie	Ki➊jo➊wie
kilka	kil➊ka
kilku	kil➊ku
kilometrów	ki➊lo➊me➊trów
kim	kim
klasy	kla➊sy
klientów	kli➊en➊tów
klimatu	kli➊ma➊tu
klub	klub
klubu	klu➊bu
koalicja	ko➊a➊li➊cja
koalicję	ko➊a➊li➊cję
koalicji	ko➊a➊li➊cji
kobiet	ko➊biet
kobieta	ko➊bie➊ta
kobiety	ko➊bie➊ty
kogo	ko➊go
Kohl	Kohl
kolegów	ko➊le➊gów
kolei	ko➊le➊i
kolej	ko➊lej
kolejne	ko➊lej➊ne
kolejny	ko➊lej➊ny
kolejnych	ko➊lej➊nych
kolonii	ko➊lo➊nii
Kolonii	Ko➊lo➊nii
koło	ko➊ło
komentarz	ko➊men➊tarz
komentarza	ko➊men➊ta➊rza
komentarze	ko➊men➊ta➊rze
Komentarze	Ko➊men➊ta➊rze
komentarzu	ko➊men➊ta➊rzu
komentarzy	ko➊men➊ta➊rzy
komentator	ko➊men➊ta➊tor
komentatorów	ko➊men➊ta➊to➊rów
komentatorzy	ko➊men➊ta➊to➊rzy
Komentatorzy	Ko➊men➊ta➊to➊rzy
komentują	ko➊men➊tu➊ją
komentuje	ko➊men➊tu➊je
komisarz	ko➊mi➊sarz
komisja	ko➊mi➊sja
Komisja	Ko➊mi➊sja
komisji	ko➊mi➊sji
Komisji	Ko➊mi➊sji
Komorowski	Ko➊mo➊row➊ski
kompromis	kom➊pro➊mis
kompromisu	kom➊pro➊mi➊su
komunikacji	ko➊mu➊ni➊ka➊cji
koncepcji	kon➊cep➊cji
koncern	kon➊cern
koncernów	kon➊cer➊nów
koncernu	kon➊cer➊nu
koncerny	kon➊cer➊ny
konferencja	kon➊fe➊ren➊cja
konferencji	kon➊fe➊ren➊cji
konflikcie	kon➊flik➊cie
konflikt	kon➊flikt
konfliktów	kon➊flik➊tów
konfliktu	kon➊flik➊tu
koniec	ko➊niec
konieczne	ko➊niecz➊ne
konieczności	ko➊niecz➊no➊ści
konieczność	ko➊niecz➊ność
koniunktury	ko➊niunk➊tu➊ry
konkluduje	kon➊klu➊du➊je
konkretne	kon➊kret➊ne
konkretnych	kon➊kret➊nych
konkurencji	kon➊ku➊ren➊cji
konsekwencje	kon➊se➊kwen➊cje
konsekwencji	kon➊se➊kwen➊cji
konstatuje	kon➊sta➊tu➊je
konstytucji	kon➊sty➊tu➊cji
konstytucyjnego	kon➊sty➊tu➊cyj➊ne➊go
Konstytucyjnego	Kon➊sty➊tu➊cyj➊ne➊go
konstytucyjny	kon➊sty➊tu➊cyj➊ny
Konstytucyjny	Kon➊sty➊tu➊cyj➊ny
konsumentów	kon➊su➊men➊tów
kontakt	kon➊takt
kontaktów	kon➊tak➊tów
kontakty	kon➊tak➊ty
kontekście	kon➊tek➊ście
kontrole	kon➊tro➊le
kontroli	kon➊tro➊li
końca	koń➊ca
końcu	koń➊cu
kończy	koń➊czy
kończyn	koń➊czyn
Korei	Ko➊re➊i
korespondent	ko➊re➊spon➊dent
korupcji	ko➊rup➊cji
korzyści	ko➊rzy➊ści
kosztów	kosz➊tów
kosztuje	kosz➊tu➊je
koszty	kosz➊ty
kościoła	ko➊ścio➊ła
Kościoła	Ko➊ścio➊ła
kościół	ko➊ściół
Kościół	Ko➊ściół
kradzieży	kra➊dzie➊ży
kraj	kraj
krajach	kra➊jach
krajami	kra➊ja➊mi
kraje	kra➊je
krajem	kra➊jem
krajowego	kra➊jo➊we➊go
krajowy	kra➊jo➊wy
krajów	kra➊jów
kraju	kra➊ju
Kremla	Krem➊la
krok	krok
krótko	krót➊ko
krwi	krwi
kryje	kry➊je
Krymu	Kry➊mu
krytycy	kry➊ty➊cy
krytycznie	kry➊tycz➊nie
krytyka	kry➊ty➊ka
krytykę	kry➊ty➊kę
krytyki	kry➊ty➊ki
krytyków	kry➊ty➊ków
krytykuje	kry➊ty➊ku➊je
kryzys	kry➊zys
kryzysem	kry➊zy➊sem
kryzysie	kry➊zy➊sie
kryzysu	kry➊zy➊su
książka	książ➊ka
książki	książ➊ki
kto	kto
ktos	ktos
ktoś	ktoś
która	któ➊ra
którą	któ➊rą
które	któ➊re
którego	któ➊re➊go
której	któ➊rej
któremu	któ➊re➊mu
który	któ➊ry
których	któ➊rych
którym	któ➊rym
którymi	któ➊ry➊mi
którzy	któ➊rzy
kultury	kul➊tu➊ry
kurs	kurs
kursu	kur➊su
kwestia	kwe➊stia
kwestiach	kwe➊stiach
kwestie	kwe➊stie
kwestii	kwe➊stii
kwietnia	kwiet➊nia
landach	lan➊dach
landów	lan➊dów
lat	lat
lata	la➊ta
latach	la➊tach
latem	la➊tem
laty	la➊ty
Lech	Lech
Lecha	Le➊cha
lecz	lecz
lekarze	le➊ka➊rze
lekarzy	le➊ka➊rzy
lepiej	le➊piej
lepsze	lep➊sze
letni	let➊ni
letnia	let➊nia
letniego	let➊nie➊go
lewica	le➊wi➊ca
Lewica	Le➊wi➊ca
lewicy	le➊wi➊cy
Lewicy	Le➊wi➊cy
Leyen	Ley➊en
leży	le➊ży
liberałów	li➊be➊ra➊łów
Libii	Li➊bii
liczą	li➊czą
liczba	licz➊ba
liczbę	licz➊bę
liczby	licz➊by
liczne	licz➊ne
licznych	licz➊nych
liczy	li➊czy
liczyć	li➊czyć
linii	li➊nii
lipca	lip➊ca
Lipsku	Lip➊sku
list	list
listopada	li➊sto➊pa➊da
listopadzie	li➊sto➊pa➊dzie
listy	li➊sty
liście	li➊ście
literatury	li➊te➊ra➊tu➊ry
Londynie	Lon➊dy➊nie
los	los
lotniczych	lot➊ni➊czych
lotniska	lot➊ni➊ska
lotnisku	lot➊ni➊sku
lotów	lo➊tów
lub	lub
ludności	lud➊no➊ści
ludzi	lu➊dzi
ludzie	lu➊dzie
ludziom	lu➊dziom
ludźmi	ludź➊mi
lutego	lu➊te➊go
łamach	ła➊mach
łatwo	ła➊two
łącznie	łącz➊nie
łączy	łą➊czy
m.in	m.in
magazyn	ma➊ga➊zyn
maja	ma➊ja
mają	ma➊ją
mając	ma➊jąc
maju	ma➊ju
mała	ma➊ła
małe	ma➊łe
Małgorzata	Mał➊go➊rza➊ta
mało	ma➊ło
małych	ma➊łych
mam	mam
mamy	ma➊my
marca	mar➊ca
marcu	mar➊cu
matka	mat➊ka
matki	mat➊ki
mecz	mecz
meczu	me➊czu
media	me➊dia
mediach	me➊diach
mediów	me➊diów
Menem	Me➊nem
Merkur	Mer➊kur
metę	me➊tę
metrów	me➊trów
Metzner	Metz➊ner
mężczyzn	męż➊czyzn
mężczyzna	męż➊czy➊zna
mężczyźni	męż➊czyź➊ni
MFW	MFW
miał	miał
miała	mia➊ła
miałaby	mia➊ła➊by
miałby	miał➊by
miało	mia➊ło
miały	mia➊ły
mianem	mia➊nem
mianowicie	mia➊no➊wi➊cie
miast	miast
miasta	mia➊sta
miastach	mia➊stach
miasto	mia➊sto
mieć	mieć
miejsc	miejsc
miejsca	miej➊sca
miejscach	miej➊scach
miejsce	miej➊sce
miejscem	miej➊scem
miejscowości	miej➊sco➊wo➊ści
miejscu	miej➊scu
mieli	mie➊li
mierze	mie➊rze
miesiącach	mie➊sią➊cach
miesiące	mie➊sią➊ce
miesięcy	mie➊się➊cy
mieszka	miesz➊ka
mieszkańców	miesz➊kań➊ców
mieszkańcy	miesz➊kań➊cy
mieście	mie➊ście
między	mię➊dzy
międzynarodowa	mię➊dzy➊na➊ro➊do➊wa
międzynarodowe	mię➊dzy➊na➊ro➊do➊we
międzynarodowego	mię➊dzy➊na➊ro➊do➊we➊go
międzynarodowej	mię➊dzy➊na➊ro➊do➊wej
międzynarodowych	mię➊dzy➊na➊ro➊do➊wych
międzynarodowym	mię➊dzy➊na➊ro➊do➊wym
migracji	mi➊gra➊cji
migrantów	mi➊gran➊tów
miliarda	mi➊liar➊da
miliardów	mi➊liar➊dów
miliardy	mi➊liar➊dy
milion	mi➊lion
miliona	mi➊lio➊na
milionów	mi➊lio➊nów
miliony	mi➊lio➊ny
mimo	mi➊mo
minionych	mi➊nio➊nych
minister	mi➊ni➊ster
ministerstwa	mi➊ni➊ster➊stwa
ministerstwo	mi➊ni➊ster➊stwo
ministra	mi➊ni➊stra
ministrem	mi➊ni➊strem
ministrowie	mi➊ni➊stro➊wie
ministrów	mi➊ni➊strów
minut	mi➊nut
misja	mi➊sja
misji	mi➊sji
mistrzostw	mi➊strzostw
mld	mld
mln	mln
młodych	mło➊dych
młodzi	mło➊dzi
młodzież	mło➊dzież
młodzieży	mło➊dzie➊ży
mnie	mnie
mniej	mniej
mniejszości	mniej➊szo➊ści
mocno	moc➊no
mocy	mo➊cy
model	mo➊del
mogą	mo➊gą
mogę	mo➊gę
mogli	mo➊gli
mogła	mo➊gła
mogłaby	mo➊gła➊by
mogło	mo➊gło
mogłoby	mo➊gło➊by
mogły	mo➊gły
mogłyby	mo➊gły➊by
moim	mo➊im
moje	mo➊je
momencie	mo➊men➊cie
momentu	mo➊men➊tu
monachijska	mo➊na➊chij➊ska
monachijski	mo➊na➊chij➊ski
monachijskiej	mo➊na➊chij➊skiej
Monachium	Mo➊na➊chium
Monika	Mo➊ni➊ka
Moskwa	Mo➊skwa
Moskwie	Mo➊skwie
Moskwy	Mo➊skwy
mowa	mo➊wa
mowy	mo➊wy
może	mo➊że
możemy	mo➊że➊my
możliwe	moż➊li➊we
możliwości	moż➊li➊wo➊ści
możliwość	moż➊li➊wo➊ść
można	moż➊na
mógł	mógł
mógłby	mógł➊by
mówi	mó➊wi
mówią	mó➊wią
mówiąc	mó➊wiąc
mówić	mó➊wić
mówił	mó➊wił
mso	mso
MSW	MSW
MSZ	MSZ
mundialu	mun➊dia➊lu
muru	mu➊ru
musi	mu➊si
musiał	mu➊siał
musiała	mu➊sia➊ła
musiały	mu➊sia➊ły
musieli	mu➊sie➊li
musimy	mu➊si➊my
muszą	mu➊szą
muzeum	mu➊ze➊um
Muzeum	Mu➊ze➊um
muzułmanów	mu➊zuł➊ma➊nów
muzyki	mu➊zy➊ki
myśl	myśl
myślą	my➊ślą
myślenia	my➊śle➊nia
myśli	my➊śli
nad	nad
nadal	na➊dal
Nadrenii	Nad➊re➊nii
nadziei	na➊dzie➊i
nadzieja	na➊dzie➊ja
nadzieje	na➊dzie➊je
nadzieję	na➊dzie➊ję
naftowej	naf➊to➊wej
nagle	na➊gle
nagroda	na➊gro➊da
Nagroda	Na➊gro➊da
nagrodę	na➊gro➊dę
nagrody	na➊gro➊dy
najbardziej	naj➊bar➊dziej
najbliższych	naj➊bliż➊szych
najczęściej	naj➊czę➊ściej
najlepiej	naj➊le➊piej
najlepszym	naj➊lep➊szym
najmniej	naj➊mniej
najnowsze	naj➊now➊sze
najnowszych	naj➊now➊szych
najpierw	naj➊pierw
najpóźniej	naj➊póź➊niej
najszybciej	naj➊szyb➊ciej
najważniejsze	naj➊waż➊niej➊sze
najważniejszych	naj➊waż➊niej➊szych
najważniejszym	naj➊waż➊niej➊szym
najwięcej	naj➊wię➊cej
największą	naj➊więk➊szą
największe	naj➊więk➊sze
największy	naj➊więk➊szy
największych	naj➊więk➊szych
największym	naj➊więk➊szym
najwyraźniej	naj➊wy➊raź➊niej
najwyższy	naj➊wyż➊szy
należałoby	na➊le➊ża➊ło➊by
należą	na➊le➊żą
należy	na➊le➊ży
nam	nam
napisał	na➊pi➊sał
narodowe	na➊ro➊do➊we
narodowego	na➊ro➊do➊we➊go
narodowej	na➊ro➊do➊wej
narodowo	na➊ro➊do➊wo
narodowych	na➊ro➊do➊wych
narodów	na➊ro➊dów
Narodów	Na➊ro➊dów
narodu	na➊ro➊du
naród	na➊ród
nas	nas
nasi	na➊si
następnie	na➊stęp➊nie
następnych	na➊stęp➊nych
nastroje	na➊stro➊je
nasz	nasz
nasza	na➊sza
naszą	na➊szą
nasze	na➊sze
naszego	na➊sze➊go
naszej	na➊szej
naszych	na➊szych
naszym	na➊szym
NATO	NA➊TO
natomiast	na➊to➊miast
natychmiast	na➊tych➊miast
nauki	na➊u➊ki
naukowców	na➊u➊kow➊ców
naukowcy	na➊u➊kow➊cy
nawet	na➊wet
nawiązuje	na➊wią➊zu➊je
nazywa	na➊zy➊wa
negocjacje	ne➊go➊cja➊cje
neonazistów	ne➊o➊na➊zi➊stów
nią	nią
nic	nic
nich	nich
niczego	ni➊cze➊go
niczym	ni➊czym
nie	nie
niebezpieczeństwo	nie➊bez➊pie➊czeń➊stwo
nieco	nie➊co
niedawna	nie➊daw➊na
niedawno	nie➊daw➊no
niedzielę	nie➊dzie➊lę
niego	nie➊go
niej	niej
niektóre	nie➊któ➊re
niektórych	nie➊któ➊rych
niektórzy	nie➊któ➊rzy
niemal	nie➊mal
Niemcami	Niem➊ca➊mi
Niemcom	Niem➊com
Niemców	Niem➊ców
Niemcy	Niem➊cy
niemczech	niem➊czech
Niemczech	Niem➊czech
Niemiec	Nie➊miec
niemieccy	nie➊miec➊cy
niemiecka	nie➊miec➊ka
Niemiecka	Nie➊miec➊ka
niemiecką	nie➊miec➊ką
niemiecki	nie➊miec➊ki
niemieckich	nie➊miec➊kich
niemieckie	nie➊miec➊kie
niemieckiego	nie➊miec➊kie➊go
niemieckiej	nie➊miec➊kiej
niemieckiemu	nie➊miec➊kie➊mu
niemieckim	nie➊miec➊kim
niemieckimi	nie➊miec➊ki➊mi
niemiecko	nie➊miec➊ko
niemiecku	nie➊miec➊ku
niemniej	nie➊mniej
nienawiści	nie➊na➊wi➊ści
niespełna	nie➊speł➊na
niestety	nie➊ste➊ty
niewiele	nie➊wie➊le
niezależnie	nie➊za➊leż➊nie
niezwykle	nie➊zwy➊kle
nigdy	ni➊gdy
nikogo	ni➊ko➊go
nikt	nikt
nim	nim
nimi	ni➊mi
niż	niż
Nobla	No➊bla
noc	noc
nocy	no➊cy
Norbert	Nor➊bert
Norymberdze	No➊rym➊ber➊dze
nowa	no➊wa
nową	no➊wą
nowe	no➊we
nowego	no➊we➊go
nowej	no➊wej
nowo	no➊wo
nowy	no➊wy
nowych	no➊wych
nowym	no➊wym
nożnej	noż➊nej
NPD	NPD
NRD	NRD
NSA	NSA
NSU	NSU
oba	oba
obaj	obaj
Obama	Oba➊ma
Obamy	Oba➊my
obawia	oba➊wia
obawiają	oba➊wia➊ją
obawy	oba➊wy
obecna	obec➊na
obecne	obec➊ne
obecnego	obec➊ne➊go
obecnej	obec➊nej
obecnie	obec➊nie
obecności	obec➊no➊ści
obecność	obec➊ność
obecny	obec➊ny
obie	obie
obliczu	ob➊li➊czu
obok	obok
obowiązek	obo➊wią➊zek
obowiązuje	obo➊wią➊zu➊je
obozie	obo➊zie
obozu	obo➊zu
obóz	obóz
obrad	ob➊rad
obraz	ob➊raz
obrazy	ob➊ra➊zy
obronie	obro➊nie
obrony	obro➊ny
obroty	ob➊ro➊ty
obserwatorów	ob➊ser➊wa➊to➊rów
obszarze	ob➊sza➊rze
obu	obu
oburzenie	obu➊rze➊nie
OBWE	OBWE
obydwu	oby➊dwu
obywatele	oby➊wa➊te➊le
obywateli	oby➊wa➊te➊li
ocenia	oce➊nia
oceny	oce➊ny
ochrona	ochro➊na
ochronę	ochro➊nę
ochrony	ochro➊ny
oczach	oczach
oczekiwać	ocze➊ki➊wać
oczekiwania	ocze➊ki➊wa➊nia
oczekuje	ocze➊ku➊je
oczy	oczy
oczywiście	oczy➊wi➊ście
odbędzie	od➊bę➊dzie
odbyła	od➊by➊ła
odbywa	od➊by➊wa
odc	odc
odgrywa	od➊gry➊wa
odnosi	od➊no➊si
odnośnie	od➊noś➊nie
odp	odp
odpowiada	od➊po➊wia➊da
odpowiedzi	od➊po➊wie➊dzi
odpowiedzialności	od➊po➊wie➊dzial➊no➊ści
odpowiedzialność	od➊po➊wie➊dzial➊ność
odpowiedzialny	od➊po➊wie➊dzial➊ny
odpowiedź	od➊po➊wiedź
Odrą	Od➊rą
odrzuca	od➊rzu➊ca
odrzucił	od➊rzu➊cił
odszkodowania	od➊szko➊do➊wa➊nia
odszkodowań	od➊szko➊do➊wań
odwagi	od➊wa➊gi
OECD	OECD
oferta	ofer➊ta
ofertę	ofer➊tę
oferty	ofer➊ty
oferuje	ofe➊ru➊je
ofiar	ofiar
ofiarami	ofia➊ra➊mi
ofiarą	ofia➊rą
ofiary	ofia➊ry
oficjalnie	ofi➊cjal➊nie
ogóle	ogó➊le
ograniczenia	ogra➊ni➊cze➊nia
ogromne	ogrom➊ne
ojca	oj➊ca
ojciec	oj➊ciec
oka	oka
okazać	oka➊zać
okazało	oka➊za➊ło
okazji	oka➊zji
okazuje	oka➊zu➊je
okaże	oka➊że
okoliczności	oko➊licz➊no➊ści
około	oko➊ło
okres	okres
okresie	okre➊sie
okresu	okre➊su
określa	okre➊śla
określił	okre➊ślił
ona	ona
one	one
oni	oni
online	on➊line
Online	On➊line
ono	ono
ONZ	ONZ
operacji	ope➊ra➊cji
opieki	opie➊ki
opinia	opi➊nia
opinię	opi➊nię
opinii	opi➊nii
opisuje	opi➊su➊je
opla	opla
Opla	Opla
opowiada	opo➊wia➊da
opowiedział	opo➊wie➊dział
opozycja	opo➊zy➊cja
opr	opr
oprócz	oprócz
oraz	oraz
organizacja	or➊ga➊ni➊za➊cja
organizacje	or➊ga➊ni➊za➊cje
organizacji	or➊ga➊ni➊za➊cji
organizatorzy	or➊ga➊ni➊za➊to➊rzy
orzeczenie	orze➊cze➊nie
osiągnąć	osią➊gnąć
osiągnięcia	osią➊gnię➊cia
osiem	osiem
osoba	oso➊ba
osobiście	oso➊bi➊ście
osobowych	oso➊bo➊wych
osoby	oso➊by
osób	osób
ostatecznie	osta➊tecz➊nie
ostatni	ostat➊ni
ostatnich	ostat➊nich
ostatnie	ostat➊nie
ostatniego	ostat➊nie➊go
ostatniej	ostat➊niej
ostatnim	ostat➊nim
ostatnio	ostat➊nio
ostro	ostro
ostrzega	ostrze➊ga
ostrzegają	ostrze➊ga➊ją
ostrzegł	ostrzegł
oszczędności	oszczęd➊no➊ści
ośmiu	oś➊miu
oświadczenie	oświad➊cze➊nie
oświadczeniu	oświad➊cze➊niu
oświadczył	oświad➊czył
oświadczyła	oświad➊czy➊ła
oto	oto
otrzyma	otrzy➊ma
otrzymał	otrzy➊mał
Otto	Ot➊to
otwarcia	otwar➊cia
otwarcie	otwar➊cie
otwarte	otwar➊te
oznacza	ozna➊cza
ożywienia	oży➊wie➊nia
pacjentów	pa➊cjen➊tów
pakiet	pa➊kiet
pakt	pakt
paktu	pak➊tu
pamięci	pa➊mię➊ci
pamięć	pa➊mięć
pan	pan
Pan	Pan
pana	pa➊na
Pana	Pa➊na
pani	pa➊ni
panuje	pa➊nu➊je
państw	państw
państwa	pań➊stwa
państwach	pań➊stwach
państwami	pań➊stwa➊mi
państwem	pań➊stwem
państwie	pań➊stwie
państwo	pań➊stwo
państwowe	pań➊stwo➊we
państwowej	pań➊stwo➊wej
państwowych	pań➊stwo➊wych
papież	pa➊pież
papieża	pa➊pie➊ża
Paprzyca	Pa➊przy➊ca
parę	pa➊rę
parlamencie	par➊la➊men➊cie
parlament	par➊la➊ment
parlamentarnej	par➊la➊men➊tar➊nej
parlamentarnych	par➊la➊men➊tar➊nych
parlamentu	par➊la➊men➊tu
partia	par➊tia
partią	par➊tią
partie	par➊tie
partię	par➊tię
partii	par➊tii
partnera	part➊ne➊ra
partnerem	part➊ne➊rem
partnerów	part➊ne➊rów
partnerstwa	part➊ner➊stwa
Paryżu	Pa➊ry➊żu
pasażerów	pa➊sa➊że➊rów
Paweł	Pa➊weł
Pawlak	Paw➊lak
Pawła	Paw➊ła
października	paź➊dzier➊ni➊ka
pełne	peł➊ne
pełni	peł➊ni
pełnomocnik	peł➊no➊moc➊nik
perspektywy	per➊spek➊ty➊wy
Peter	Pe➊ter
pewien	pe➊wien
pewne	pew➊ne
pewnego	pew➊ne➊go
pewno	pew➊no
pewnością	pew➊no➊ścią
pewnym	pew➊nym
piątek	pią➊tek
pieniądze	pie➊nią➊dze
pieniędzy	pie➊nię➊dzy
pierwsza	pierw➊sza
pierwszą	pierw➊szą
pierwsze	pierw➊sze
pierwszego	pierw➊sze➊go
pierwszej	pierw➊szej
pierwszy	pierw➊szy
pierwszych	pierw➊szych
pierwszym	pierw➊szym
pięciu	pię➊ciu
pięć	pięć
piłce	pił➊ce
piłki	pił➊ki
Pis	Pis
PiS	PiS
PIS	PIS
piszą	pi➊szą
pisze	pi➊sze
pkb	pkb
PKB	PKB
placówki	pla➊ców➊ki
placu	pla➊cu
plan	plan
planowane	pla➊no➊wa➊ne
planów	pla➊nów
planu	pla➊nu
planuje	pla➊nu➊je
plany	pla➊ny
płac	płac
płacić	pła➊cić
pobliżu	po➊bli➊żu
pobytu	po➊by➊tu
pochodzą	po➊cho➊dzą
pochodzenia	po➊cho➊dze➊nia
pochodzi	po➊cho➊dzi
początek	po➊czą➊tek
początku	po➊cząt➊ku
poczucie	po➊czu➊cie
pod	pod
podaje	po➊da➊je
podał	po➊dał
podatek	po➊da➊tek
podatki	po➊dat➊ki
podatkowe	po➊dat➊ko➊we
podatkowych	po➊dat➊ko➊wych
podatków	po➊dat➊ków
podatku	po➊dat➊ku
podatników	po➊dat➊ni➊ków
podczas	pod➊czas
podejrzanych	po➊dej➊rza➊nych
podejrzenie	po➊dej➊rze➊nie
podjęcia	pod➊ję➊cia
podkreśla	pod➊kre➊śla
podkreślił	pod➊kre➊ślił
podkreśliła	pod➊kre➊śli➊ła
podobne	po➊dob➊ne
podobnie	po➊dob➊nie
podobno	po➊dob➊no
podobnym	po➊dob➊nym
podróż	po➊dróż
podróży	po➊dró➊ży
podstawie	pod➊sta➊wie
podstawowych	pod➊sta➊wo➊wych
podsumowuje	pod➊su➊mo➊wu➊je
podwyżki	pod➊wyż➊ki
podział	po➊dział
podziału	po➊dzia➊łu
poglądów	po➊glą➊dów
pogodzić	po➊go➊dzić
poinformował	po➊in➊for➊mo➊wa➊ł
poinformowała	po➊in➊for➊mo➊wa➊ła
pojawia	po➊ja➊wia
pojawiają	po➊ja➊wia➊ją
pojawiły	po➊ja➊wi➊ły
pojazdów	po➊jaz➊dów
pojednania	po➊jed➊na➊nia
pojęcia	po➊ję➊cia
pokazać	po➊ka➊zać
pokazuje	po➊ka➊zu➊je
pokojowego	po➊ko➊jo➊we➊go
pokojowej	po➊ko➊jo➊wej
pokoju	po➊ko➊ju
pokolenia	po➊ko➊le➊nia
pokój	po➊kój
Polacy	Po➊la➊cy
Polak	Po➊lak
Polakom	Po➊la➊kom
Polaków	Po➊la➊ków
polega	po➊le➊ga
policja	po➊li➊cja
policjantów	po➊li➊cjan➊tów
policję	po➊li➊cję
policji	po➊li➊cji
polityce	po➊li➊ty➊ce
politycy	po➊li➊ty➊cy
polityczna	po➊li➊tycz➊na
polityczną	po➊li➊tycz➊ną
polityczne	po➊li➊tycz➊ne
politycznego	po➊li➊tycz➊ne➊go
politycznej	po➊li➊tycz➊nej
politycznie	po➊li➊tycz➊nie
polityczny	po➊li➊tycz➊ny
politycznych	po➊li➊tycz➊nych
politycznym	po➊li➊tycz➊nym
polityk	po➊li➊tyk
polityka	po➊li➊ty➊ka
polityką	po➊li➊ty➊ką
politykę	po➊li➊ty➊kę
polityki	po➊li➊ty➊ki
polityków	po➊li➊ty➊ków
polsce	pol➊sce
Polsce	Pol➊sce
polscy	pol➊scy
polska	pol➊ska
Polska	Pol➊ska
polską	pol➊ską
Polską	Pol➊ską
Polskę	Pol➊skę
polski	pol➊ski
Polski	Pol➊ski
polskich	pol➊skich
polskie	pol➊skie
polskiego	pol➊skie➊go
polskiej	pol➊skiej
polskim	pol➊skim
polskimi	pol➊ski➊mi
polsko	pol➊sko
polu	po➊lu
połowa	po➊ło➊wa
połowę	po➊ło➊wę
połowie	po➊ło➊wie
południowej	po➊łu➊dnio➊wej
Południowej	Po➊łu➊dnio➊wej
południu	po➊łu➊dniu
pomiędzy	po➊mię➊dzy
pomimo	po➊mi➊mo
Pomimo	Po➊mi➊mo
pomoc	po➊moc
pomocą	po➊mo➊cą
pomocy	po➊mo➊cy
pomoże	po➊mo➊że
pomóc	po➊móc
pomysł	po➊mysł
ponad	po➊nad
ponadto	po➊nad➊to
Ponadto	Po➊nad➊to
poniedziałek	po➊nie➊dzia➊łek
ponieważ	po➊nie➊waż
poniżej	po➊ni➊żej
ponownie	po➊now➊nie
poparcia	po➊par➊cia
poparcie	po➊par➊cie
popiera	po➊pie➊ra
poprawę	po➊pra➊wę
poprawy	po➊pra➊wy
poprzez	po➊przez
popularności	po➊pu➊lar➊no➊ści
popyt	po➊pyt
porozumienia	po➊ro➊zu➊mie➊nia
porozumienie	po➊ro➊zu➊mie➊nie
portal	por➊tal
pory	po➊ry
porządku	po➊rząd➊ku
poselskiego	po➊sel➊skie➊go
poseł	po➊seł
posiada	po➊sia➊da
posiedzeniu	po➊sie➊dze➊niu
posłowie	po➊sło➊wie
posłów	po➊słów
post	post
Post	Post
POST	POST
postaci	po➊sta➊ci
postawić	po➊sta➊wić
postępowania	po➊stę➊po➊wa➊nia
postępowanie	po➊stę➊po➊wa➊nie
poszczególnych	po➊szcze➊gól➊nych
potem	po➊tem
potrafi	po➊tra➊fi
potrzeba	po➊trze➊ba
potrzebna	po➊trzeb➊na
potrzebne	po➊trzeb➊ne
potrzebny	po➊trzeb➊ny
potrzebują	po➊trze➊bu➊ją
potrzebuje	po➊trze➊bu➊je
potwierdza	po➊twier➊dza
potwierdził	po➊twier➊dził
poważne	po➊waż➊ne
poważnie	po➊waż➊nie
powiedział	po➊wie➊dział
powiedziała	po➊wie➊dzia➊ła
powiedzieć	po➊wie➊dzieć
powinien	po➊wi➊nien
powinna	po➊win➊na
powinni	po➊win➊ni
powinniśmy	po➊win➊ni➊śmy
powinno	po➊win➊no
powinny	po➊win➊ny
powodem	po➊wo➊dem
powodów	po➊wo➊dów
powodu	po➊wo➊du
powody	po➊wo➊dy
powoli	po➊wo➊li
powołując	po➊wo➊łu➊jąc
powód	po➊wód
powrót	po➊wrót
powstaje	po➊wsta➊je
powstał	po➊wstał
powstała	po➊wsta➊ła
powstanie	po➊wsta➊nie
powstrzymać	po➊wstrzy➊mać
poza	po➊za
poziom	po➊ziom
poziomie	po➊zio➊mie
poziomu	po➊zio➊mu
pozostać	po➊zo➊stać
pozostaje	po➊zo➊sta➊je
pozostanie	po➊zo➊sta➊nie
pozwala	po➊zwa➊la
pozwolić	po➊zwo➊lić
pozycję	po➊zy➊cję
pozycji	po➊zy➊cji
pozytywne	po➊zy➊tyw➊ne
pół	pół
północnej	pół➊noc➊nej
Północnej	Pół➊noc➊nej
północy	pół➊no➊cy
później	póź➊niej
późno	póź➊no
prac	prac
praca	pra➊ca
prace	pra➊ce
pracę	pra➊cę
pracodawców	pra➊co➊daw➊ców
pracować	pra➊co➊wać
pracownicy	pra➊cow➊ni➊cy
pracowników	pra➊cow➊ni➊ków
pracują	pra➊cu➊ją
pracuje	pra➊cu➊je
pracy	pra➊cy
praktyce	prak➊ty➊ce
praktycznie	prak➊tycz➊nie
prasa	pra➊sa
prasie	pra➊sie
prasowej	pra➊so➊wej
prasowym	pra➊so➊wym
prasy	pra➊sy
praw	praw
prawa	pra➊wa
prawda	praw➊da
prawdopodobnie	praw➊do➊po➊dob➊nie
prawdy	praw➊dy
prawem	pra➊wem
prawicowych	pra➊wi➊co➊wych
prawicy	pra➊wi➊cy
prawie	pra➊wie
prawo	pra➊wo
prądu	prą➊du
premier	pre➊mier
premiera	pre➊mie➊ra
premierem	pre➊mie➊rem
presją	pre➊sją
prezentuje	pre➊zen➊tu➊je
prezes	pre➊zes
prezesa	pre➊ze➊sa
prezydencji	pre➊zy➊den➊cji
prezydenckim	pre➊zy➊den➊ckim
Prezydenckim	Pre➊zy➊den➊ckim
prezydent	pre➊zy➊dent
prezydenta	pre➊zy➊den➊ta
prezydentem	pre➊zy➊den➊tem
prezydentowi	pre➊zy➊den➊to➊wi
problem	pro➊blem
problemem	pro➊ble➊mem
problemów	pro➊ble➊mów
problemu	pro➊ble➊mu
problemy	pro➊ble➊my
proc	proc
procent	pro➊cent
proces	pro➊ces
procesie	pro➊ce➊sie
procesu	pro➊ce➊su
producenci	pro➊du➊cen➊ci
producentów	pro➊du➊cen➊tów
produkcji	pro➊duk➊cji
produktów	pro➊duk➊tów
produkty	pro➊duk➊ty
prof	prof
profesor	pro➊fe➊sor
prognozy	pro➊gno➊zy
program	pro➊gram
programie	pro➊gra➊mie
programu	pro➊gra➊mu
projekt	pro➊jekt
projektów	pro➊jek➊tów
projektu	pro➊jek➊tu
projekty	pro➊jek➊ty
prokuratura	pro➊ku➊ra➊tu➊ra
Prokuratura	Pro➊ku➊ra➊tu➊ra
propozycje	pro➊po➊zy➊cje
propozycję	pro➊po➊zy➊cję
propozycji	pro➊po➊zy➊cji
prostu	pro➊stu
protestów	pro➊te➊stów
protesty	pro➊te➊sty
prowadzą	pro➊wa➊dzą
prowadzi	pro➊wa➊dzi
prowadzić	pro➊wa➊dzić
próba	pró➊ba
próbę	pró➊bę
próbuje	pró➊bu➊je
próby	pró➊by
prywatnie	pry➊wat➊nie
prywatnych	pry➊wat➊nych
przebieg	prze➊bieg
przebywa	prze➊by➊wa
przecież	prze➊cież
przeciw	prze➊ciw
przeciwieństwie	prze➊ci➊wień➊stwie
przeciwko	prze➊ciw➊ko
przeciwnie	prze➊ciw➊nie
przeciwników	prze➊ciw➊ni➊ków
przed	przed
przede	prze➊de
przedmiotem	przed➊mio➊tem
przedsiębiorstw	przed➊się➊biorstw
przedsiębiorstwa	przed➊się➊bior➊stwa
przedstawia	przed➊sta➊wia
przedstawiciel	przed➊sta➊wi➊ciel
przedstawicielami	przed➊sta➊wi➊cie➊la➊mi
przedstawiciele	przed➊sta➊wi➊cie➊le
przedstawicieli	przed➊sta➊wi➊cie➊li
przedstawił	przed➊sta➊wił
przedtem	przed➊tem
przekonać	prze➊ko➊nać
przekonaniu	prze➊ko➊na➊niu
przekonany	prze➊ko➊na➊ny
przemoc	prze➊moc
przemocy	prze➊mo➊cy
przemówienie	prze➊mó➊wie➊nie
przemówieniu	prze➊mó➊wie➊niu
przemysł	prze➊mysł
przemysłu	prze➊my➊słu
przepisów	prze➊pi➊sów
przepisy	prze➊pi➊sy
przesłanie	prze➊sła➊nie
przestępczości	prze➊stęp➊czo➊ści
przestępstw	prze➊stępstw
przestrzeni	prze➊strze➊ni
przeszłości	prze➊szło➊ści
przeważnie	prze➊waż➊nie
przewiduje	prze➊wi➊du➊je
przewodnicząca	prze➊wod➊ni➊czą➊ca
przewodniczącego	prze➊wod➊ni➊czą➊ce➊go
przewodniczący	prze➊wod➊ni➊czą➊cy
przewodniczącym	prze➊wod➊ni➊czą➊cym
przez	przez
przy	przy
przyczyn	przy➊czyn
przyczyną	przy➊czy➊ną
przyczyny	przy➊czy➊ny
przyjął	przy➊jął
przyjęcia	przy➊ję➊cia
przyjęcie	przy➊ję➊cie
przykład	przy➊kład
przykładem	przy➊kła➊dem
przynajmniej	przy➊naj➊mniej
przyp	przyp
przypadek	przy➊pa➊dek
przypadkach	przy➊pad➊kach
przypadki	przy➊pad➊ki
przypadków	przy➊pad➊ków
przypadku	przy➊pad➊ku
przypomina	przy➊po➊mi➊na
przypuszczalnie	przy➊pusz➊czal➊nie
przyszłego	przy➊szłe➊go
przyszłości	przy➊szło➊ści
przyszłość	przy➊szłość
przyszły	przy➊szły
przyszłym	przy➊szłym
przytacza	przy➊ta➊cza
przywódców	przy➊wód➊ców
przywódcy	przy➊wód➊cy
przyznać	przy➊znać
przyznaje	przy➊zna➊je
przyznał	przy➊znał
publiczna	pu➊blicz➊na
publicznego	pu➊blicz➊ne➊go
publicznej	pu➊blicz➊nej
publicznie	pu➊blicz➊nie
publiczności	pu➊blicz➊no➊ści
publicznych	pu➊blicz➊nych
publikacji	pu➊bli➊ka➊cji
punkt	punkt
punktem	punk➊tem
punktów	punk➊tów
punktu	punk➊tu
punkty	punk➊ty
Putin	Pu➊tin
Putina	Pu➊ti➊na
Putinem	Pu➊ti➊nem
pyta	py➊ta
pytania	py➊ta➊nia
pytanie	py➊ta➊nie
rację	ra➊cję
raczej	ra➊czej
rada	ra➊da
Rada	Ra➊da
rady	ra➊dy
Rady	Ra➊dy
radzie	ra➊dzie
Radzie	Ra➊dzie
ramach	ra➊mach
ramienia	ra➊mie➊nia
rannych	ran➊nych
rano	ra➊no
raporcie	ra➊por➊cie
raport	ra➊port
raportu	ra➊por➊tu
raz	raz
razem	ra➊zem
razie	ra➊zie
razu	ra➊zu
razy	ra➊zy
reakcja	re➊ak➊cja
reakcje	re➊ak➊cje
reakcji	re➊ak➊cji
realizacji	re➊ali➊za➊cji
red	red
red.odp	red.odp
redukcji	re➊duk➊cji
referendum	re➊fe➊ren➊dum
reform	re➊form
reforma	re➊for➊ma
regionach	re➊gio➊nach
regionie	re➊gio➊nie
regionów	re➊gio➊nów
regionu	re➊gio➊nu
regulacji	re➊gu➊la➊cji
reguły	re➊gu➊ły
relacje	re➊la➊cje
relacji	re➊la➊cji
religii	re➊li➊gii
reprezentacji	re➊pre➊zen➊ta➊cji
republika	re➊pu➊bli➊ka
Republika	Re➊pu➊bli➊ka
republiki	re➊pu➊bli➊ki
Republiki	Re➊pu➊bli➊ki
resortu	re➊sor➊tu
rewolucji	re➊wo➊lu➊cji
rezygnacji	re➊zy➊gna➊cji
reżim	re➊żim
reżimu	re➊żi➊mu
ręce	rę➊ce
rękach	rę➊kach
rękę	rę➊kę
RFN	RFN
Robert	Ro➊bert
robi	ro➊bi
robią	ro➊bią
robić	ro➊bić
robotników	ro➊bot➊ni➊ków
rocznicę	rocz➊ni➊cę
rocznicy	ro➊czni➊cy
rocznie	rocz➊nie
rodzaju	ro➊dza➊ju
rodzice	ro➊dzi➊ce
rodziców	ro➊dzi➊ców
rodzin	ro➊dzin
rodzina	ro➊dzi➊na
rodziny	ro➊dzi➊ny
rok	rok
rokiem	ro➊kiem
rokowań	ro➊ko➊wań
roku	ro➊ku
rola	ro➊la
rolę	ro➊lę
roli	ro➊li
rolnictwa	rol➊ni➊ctwa
Romaniec	Ro➊ma➊niec
ropy	ro➊py
Rosja	Ro➊sja
Rosjan	Ro➊sjan
Rosjanie	Ro➊sja➊nie
Rosją	Ro➊sją
Rosję	Ro➊sję
Rosji	Ro➊sji
rosyjski	ro➊syj➊ski
rosyjskich	ro➊syj➊skich
rosyjskie	ro➊syj➊skie
rosyjskiego	ro➊syj➊skie➊go
rosyjskiej	ro➊syj➊skiej
rosyjskim	ro➊syj➊skim
rośnie	ro➊śnie
rozdział	roz➊dział
rozgłośni	roz➊gło➊śni
rozmawiać	roz➊ma➊wiać
rozmowach	roz➊mo➊wach
rozmowie	roz➊mo➊wie
rozmowy	roz➊mo➊wy
rozmów	roz➊mów
rozpoczął	roz➊po➊czął
rozpoczęła	roz➊po➊czę➊ła
rozpoczyna	roz➊po➊czy➊na
rozwiązać	roz➊wią➊zać
rozwiązania	roz➊wią➊za➊nia
rozwiązaniem	roz➊wią➊za➊niem
rozwiązań	roz➊wią➊zań
rozwoju	roz➊wo➊ju
rozwój	roz➊wój
również	rów➊nież
równocześnie	rów➊no➊cze➊śnie
róża	ró➊ża
Róża	Ró➊ża
różne	róż➊ne
różnice	róż➊ni➊ce
różnych	róż➊nych
ruch	ruch
ruchu	ru➊chu
Rumunii	Ru➊mu➊nii
rynek	ry➊nek
rynkach	ryn➊kach
rynki	ryn➊ki
rynków	ryn➊ków
rynku	ryn➊ku
ryzyka	ry➊zy➊ka
ryzyko	ry➊zy➊ko
rzadko	rzad➊ko
rząd	rząd
rządem	rzą➊dem
rządowej	rzą➊do➊wej
rządowi	rzą➊do➊wi
rządu	rzą➊du
rządy	rzą➊dy
rządzącej	rzą➊dzą➊cej
rządzie	rzą➊dzie
rzecz	rzecz
rzeczniczka	rzecz➊nicz➊ka
rzecznik	rzecz➊nik
rzeczy	rze➊czy
rzeczywistości	rze➊czy➊wi➊sto➊ści
rzeczywiście	rze➊czy➊wi➊ście
rzekomo	rze➊ko➊mo
rzeszy	rze➊szy
Rzeszy	Rze➊szy
rzędu	rzę➊du
Saksonii	Sak➊so➊nii
sam	sam
sama	sa➊ma
samą	sa➊mą
same	sa➊me
samego	sa➊me➊go
samej	sa➊mej
sami	sa➊mi
samo	sa➊mo
samochodów	sa➊mo➊cho➊dów
samochody	sa➊mo➊cho➊dy
samochód	sa➊mo➊chód
samolot	sa➊mo➊lot
samolotów	sa➊mo➊lo➊tów
samolotu	sa➊mo➊lo➊tu
samych	sa➊mych
samym	sa➊mym
sankcje	sank➊cje
sankcji	sank➊cji
Sarkozy	Sar➊ko➊zy
sąd	sąd
Sąd	Sąd
sądem	są➊dem
sądu	są➊du
sąsiadów	są➊sia➊dów
sceny	sce➊ny
sejmu	sej➊mu
Sejmu	Sej➊mu
sekretarz	se➊kre➊tarz
sens	sens
sensie	sen➊sie
serca	ser➊ca
sędziowie	sę➊dzio➊wie
sie	sie
siebie	sie➊bie
sieci	sie➊ci
sieć	sieć
siedem	sie➊dem
siedmiu	sied➊miu
sierpnia	sierp➊nia
się	się
sięga	się➊ga
Sigmar	Sig➊mar
silne	sil➊ne
sił	sił
siła	si➊ła
siłą	si➊łą
siłę	si➊łę
siły	si➊ły
skalę	ska➊lę
skali	ska➊li
skandal	skan➊dal
skandalu	skan➊da➊lu
skąd	skąd
skład	skład
skrajnie	skraj➊nie
skrytykował	skry➊ty➊ko➊wał
skutek	sku➊tek
skutki	skut➊ki
słowa	sło➊wa
słowo	sło➊wo
słów	słów
słusznie	słusz➊nie
służb	służb
służby	służ➊by
służy	słu➊ży
służyć	słu➊żyć
słychać	sły➊chać
sobą	so➊bą
sobie	so➊bie
sobotę	so➊bo➊tę
socjaldemokraci	so➊cjal➊de➊mo➊kra➊ci
socjaldemokratów	so➊cjal➊de➊mo➊kra➊tów
socjalne	so➊cjal➊ne
socjalnych	so➊cjal➊nych
sojusz	so➊jusz
sojuszu	so➊ju➊szu
solidarności	so➊li➊dar➊no➊ści
solidarność	so➊li➊dar➊ność
sondażu	son➊da➊żu
spada	spa➊da
spadek	spa➊dek
spadku	spad➊ku
spadła	spa➊dła
SPD	SPD
specjalistów	spe➊cja➊li➊stów
specjalne	spe➊cjal➊ne
specjalnych	spe➊cjal➊nych
spod	spod
spodziewać	spo➊dzie➊wać
społeczeństwa	spo➊łe➊czeń➊stwa
społeczeństwie	spo➊łe➊czeń➊stwie
społeczeństwo	spo➊łe➊czeń➊stwo
społeczne	spo➊łecz➊ne
społecznej	spo➊łecz➊nej
społecznych	spo➊łecz➊nych
sporo	spo➊ro
sporu	spo➊ru
spory	spo➊ry
sporze	spo➊rze
sposób	spo➊sób
spośród	spo➊śród
spotkał	spo➊tkał
spotkania	spo➊tka➊nia
spotkanie	spo➊tka➊nie
spotkaniu	spo➊tka➊niu
spotkań	spo➊tkań
spór	spór
spraw	spraw
sprawa	spra➊wa
sprawach	spra➊wach
sprawą	spra➊wą
sprawców	spraw➊ców
sprawcy	spraw➊cy
sprawę	spra➊wę
sprawia	spra➊wia
sprawie	spra➊wie
sprawiedliwości	spra➊wie➊dli➊wo➊ści
sprawy	spra➊wy
sprzed	sprzed
sprzedaż	sprze➊daż
sprzedaży	sprze➊da➊ży
stabilizacji	sta➊bi➊li➊za➊cji
stacji	sta➊cji
stać	stać
Stadt	Stadt
STADT	STADT
stają	sta➊ją
staje	sta➊je
stale	sta➊le
stał	stał
stała	sta➊ła
stałe	sta➊łe
stało	sta➊ło
stały	sta➊ły
stan	stan
stanie	sta➊nie
stanowi	sta➊no➊wi
stanowią	sta➊no➊wią
stanowisk	sta➊no➊wisk
stanowiska	sta➊no➊wi➊ska
stanowisko	sta➊no➊wi➊sko
stanowisku	sta➊no➊wi➊sku
stanów	sta➊nów
Stanów	Sta➊nów
stanu	sta➊nu
stany	sta➊ny
Stany	Sta➊ny
stara	sta➊ra
starszych	star➊szych
Stasi	Sta➊si
Stasik	Sta➊sik
statystyczny	sta➊ty➊stycz➊ny
Statystyczny	Sta➊ty➊stycz➊ny
stawia	sta➊wia
stąd	stąd
sto	sto
stoi	sto➊i
stoją	sto➊ją
stolicy	sto➊li➊cy
stopniu	stop➊niu
stos	stos
stosunek	sto➊su➊nek
stosunkach	sto➊sun➊kach
stosunki	sto➊sun➊ki
stosunkowo	sto➊sun➊ko➊wo
stosunków	sto➊sun➊ków
stosunku	sto➊sun➊ku
stowarzyszenia	sto➊wa➊rzy➊sze➊nia
strach	strach
strachu	stra➊chu
strajk	strajk
strajku	straj➊ku
strategia	stra➊te➊gia
strategii	stra➊te➊gii
straty	stra➊ty
strefie	stre➊fie
strefy	stre➊fy
stron	stron
strona	stro➊na
stronach	stro➊nach
stronę	stro➊nę
stronie	stro➊nie
strony	stro➊ny
struktur	struk➊tur
stu	stu
studenci	stu➊den➊ci
studentów	stu➊den➊tów
studia	stu➊dia
studiów	stu➊diów
Stuttgarcie	Stutt➊gar➊cie
stwierdza	stwier➊dza
stwierdził	stwier➊dził
stwierdziła	stwier➊dzi➊ła
stworzyć	stwo➊rzyć
stycznia	stycz➊nia
styczniu	stycz➊niu
stylu	sty➊lu
sukces	suk➊ces
sukcesem	suk➊ce➊sem
sukcesu	suk➊ce➊su
sukcesy	suk➊ce➊sy
sumę	su➊mę
sumie	su➊mie
sumy	su➊my
swą	swą
swe	swe
swego	swe➊go
swej	swej
swoich	swo➊ich
swoim	swo➊im
swoimi	swo➊i➊mi
swoją	swo➊ją
swoje	swo➊je
swojego	swo➊je➊go
swojej	swo➊jej
swój	swój
swych	swych
swym	swym
sygnał	sy➊gnał
sygnałem	sy➊gna➊łem
Syrii	Sy➊rii
system	sys➊tem
systemie	sys➊te➊mie
systemu	sys➊te➊mu
sytuacja	sy➊tu➊acja
sytuacją	sy➊tu➊acją
sytuację	sy➊tu➊ację
sytuacji	sy➊tu➊acji
szans	szans
szansa	szan➊sa
szanse	szan➊se
szansę	szan➊sę
szczeblu	szcze➊blu
szczególnie	szcze➊gól➊nie
szczegóły	szcze➊gó➊ły
szczęście	szczę➊ście
szczycie	szczy➊cie
szczyt	szczyt
szczytem	szczy➊tem
szczytu	szczy➊tu
szef	szef
szefa	sze➊fa
szefem	sze➊fem
szefowa	sze➊fo➊wa
szefowej	sze➊fo➊wej
szefowie	sze➊fo➊wie
szefów	sze➊fów
szereg	sze➊reg
szeregach	sze➊re➊gach
szeroko	sze➊ro➊ko
sześciu	sze➊ściu
sześć	sześć
szkody	szko➊dy
szkole	szko➊le
szkołach	szko➊łach
szkoły	szko➊ły
szkół	szkół
sztuka	sztu➊ka
sztuki	sztu➊ki
szuka	szu➊ka
szukać	szu➊kać
Szwajcarii	Szwaj➊ca➊rii
szybciej	szyb➊ciej
szybko	szyb➊ko
śledztwo	śledz➊two
śmierci	śmier➊ci
śmierć	śmierć
średnio	śred➊nio
środę	śro➊dę
środki	środ➊ki
środkowej	środ➊ko➊wej
środkowo	środ➊ko➊wo
środków	środ➊ków
środowiska	śro➊do➊wi➊ska
świadczeń	świad➊czeń
świadczy	świad➊czy
świat	świat
świata	świa➊ta
światowego	świa➊to➊we➊go
światowej	świa➊to➊wej
światowym	świa➊to➊wym
świecie	świe➊cie
święta	świę➊ta
tajnych	taj➊nych
tak	tak
taka	ta➊ka
taką	ta➊ką
taki	ta➊ki
takich	ta➊kich
takie	ta➊kie
takiego	ta➊kie➊go
takiej	ta➊kiej
takim	ta➊kim
także	tak➊że
tam	tam
targach	tar➊gach
targi	tar➊gi
targów	tar➊gów
technologii	tech➊no➊lo➊gii
tego	te➊go
tej	tej
telewizji	te➊le➊wi➊zji
temat	te➊mat
tematem	te➊ma➊tem
tematów	te➊ma➊tów
tematu	te➊ma➊tu
tematy	te➊ma➊ty
temu	te➊mu
ten	ten
teraz	te➊raz
terenie	te➊re➊nie
termin	ter➊min
terroru	ter➊ro➊ru
terrorystów	ter➊ro➊ry➊stów
terrorystycznych	ter➊ro➊ry➊stycz➊nych
terroryści	ter➊ro➊ry➊ści
terroryzm	ter➊ro➊ryzm
terroryzmem	ter➊ro➊ry➊zmem
terroryzmu	ter➊ro➊ry➊zmu
terytorium	te➊ry➊to➊rium
też	też
tle	tle
tlen	tlen
tłumaczy	tłu➊ma➊czy
toczy	to➊czy
ton	ton
tonie	to➊nie
tożsamości	toż➊sa➊mo➊ści
traci	tra➊ci
tradycji	tra➊dy➊cji
tragedii	tra➊ge➊dii
trakcie	trak➊cie
traktat	trak➊tat
traktatu	trak➊ta➊tu
transportu	trans➊por➊tu
trend	trend
treści	tre➊ści
trochę	tro➊chę
trudne	trud➊ne
trudno	trud➊no
trudności	trud➊no➊ści
Trump	Trump
Trumpa	Trum➊pa
trwa	trwa
trybunał	try➊bu➊nał
Trybunał	Try➊bu➊nał
trybunału	try➊bu➊na➊łu
Trybunału	Try➊bu➊na➊łu
trzeba	trze➊ba
trzech	trzech
trzeci	trze➊ci
trzecia	trze➊cia
trzecie	trze➊cie
trzy	trzy
Turcja	Tur➊cja
Turcją	Tur➊cją
Turcji	Tur➊cji
tureckich	tu➊rec➊kich
tureckiego	tu➊rec➊kie➊go
turystów	tu➊ry➊stów
Tusk	Tusk
Tuska	Tu➊ska
tutaj	tu➊taj
tuż	tuż
twierdzą	twier➊dzą
twierdzi	twier➊dzi
tych	tych
tydzień	ty➊dzień
tygodni	ty➊go➊dni
tygodnia	ty➊go➊dnia
tygodniach	ty➊go➊dniach
tygodnie	ty➊go➊dnie
tygodnik	ty➊go➊dnik
tygodnika	ty➊go➊dni➊ka
tygodniu	ty➊go➊dniu
tyle	ty➊le
tylko	tyl➊ko
tym	tym
tymczasem	tym➊cza➊sem
Tymczasem	Tym➊cza➊sem
tymi	ty➊mi
typu	ty➊pu
tys	tys
tysiące	ty➊sią➊ce
tysięcy	ty➊się➊cy
tytuł	ty➊tuł
tytułem	ty➊tu➊łem
tytułu	ty➊tu➊łu
tzw	tzw
ubiegłego	ubie➊głe➊go
ubiegłym	ubie➊głym
uchodzi	ucho➊dzi
uchodźców	uchodź➊ców
uchodźcy	uchodź➊cy
uczelni	uczel➊ni
uczestnicy	uczest➊ni➊cy
uczestników	uczest➊ni➊ków
uczniów	uczniów
uczynić	uczy➊nić
uda	uda
udaje	uda➊je
udało	uda➊ło
udział	udział
udziałem	udzia➊łem
udziału	udzia➊łu
układ	układ
układu	ukła➊du
Ukraina	Ukra➊ina
Ukrainą	Ukra➊iną
Ukrainę	Ukra➊inę
Ukrainie	Ukra➊inie
Ukrainy	Ukra➊iny
ukraińskiego	ukra➊iń➊skie➊go
ulicy	uli➊cy
umowa	umo➊wa
umowę	umo➊wę
umowy	umo➊wy
unia	unia
Unia	Unia
unią	unią
Unią	Unią
unię	unię
Unię	Unię
unii	unii
Unii	Unii
unijne	unij➊ne
unijnego	unij➊ne➊go
unijnej	unij➊nej
unijny	unij➊ny
unijnych	unij➊nych
uniknąć	unik➊nąć
uniwersytetu	uni➊wer➊sy➊te➊tu
Uniwersytetu	Uni➊wer➊sy➊te➊tu
upadku	upad➊ku
uroczystości	uro➊czy➊sto➊ści
urząd	urząd
Urząd	Urząd
urzędu	urzę➊du
Urzędu	Urzę➊du
urzędzie	urzę➊dzie
Urzędzie	Urzę➊dzie
USA	USA
usług	usług
ustaw	ustaw
ustawa	usta➊wa
ustawę	usta➊wę
ustawy	usta➊wy
utrzymać	utrzy➊mać
utrzymania	utrzy➊ma➊nia
utrzymanie	utrzy➊ma➊nie
utrzymuje	utrzy➊mu➊je
utworzenia	utwo➊rze➊nia
utworzenie	utwo➊rze➊nie
uwagę	uwa➊gę
uwagi	uwa➊gi
uważa	uwa➊ża
uważają	uwa➊ża➊ją
uznać	uznać
uznał	uznał
uznania	uzna➊nia
uznanie	uzna➊nie
uznaniem	uzna➊niem
van	van
VAT	VAT
volkswagena	volks➊wa➊ge➊na
Volkswagena	Volks➊wa➊ge➊na
walce	wal➊ce
walczy	wal➊czy
walczyć	wal➊czyć
walka	wal➊ka
walkę	wal➊kę
walki	wal➊ki
Walter	Wal➊ter
waluty	wa➊lu➊ty
Warszawa	War➊sza➊wa
Warszawie	War➊sza➊wie
Warszawy	War➊sza➊wy
warto	war➊to
wartości	war➊to➊ści
wartość	war➊tość
warunkach	wa➊run➊kach
warunki	wa➊run➊ki
warunkiem	wa➊run➊kiem
warunków	wa➊run➊ków
Waszyngtonie	Wa➊szyng➊to➊nie
ważna	waż➊na
ważną	waż➊ną
ważne	waż➊ne
ważny	waż➊ny
ważnych	waż➊nych
ważnym	waż➊nym
wątpliwości	wąt➊pli➊wo➊ści
wbrew	wbrew
wcale	wca➊le
wchodzi	wcho➊dzi
wciąż	wciąż
wcześniej	wcze➊śniej
wczoraj	wczo➊raj
według	we➊dług
Według	We➊dług
weekend	week➊end
wejść	wejść
Westfalii	West➊fa➊lii
wewnętrznej	we➊wnętrz➊nej
wewnętrznych	we➊wnętrz➊nych
wezwał	we➊zwał
Węgier	Wę➊gier
węgla	wę➊gla
Węgry	Wę➊gry
wiadomo	wia➊do➊mo
wiadomości	wia➊do➊mo➊ści
wiadomość	wia➊do➊mość
wiary	wia➊ry
widać	wi➊dać
wideo	wi➊de➊o
widzą	wi➊dzą
widzenia	wi➊dze➊nia
widzi	wi➊dzi
wie	wie
wieczorem	wie➊czo➊rem
wiedzą	wie➊dzą
wiedzieć	wie➊dzieć
wieku	wie➊ku
wiele	wie➊le
wielka	wiel➊ka
Wielka	Wiel➊ka
wielką	wiel➊ką
wielki	wiel➊ki
wielkich	wiel➊kich
wielkie	wiel➊kie
wielkiego	wiel➊kie➊go
wielkiej	wiel➊kiej
Wielkiej	Wiel➊kiej
wielkim	wiel➊kim
wielkości	wiel➊ko➊ści
wielokrotnie	wie➊lo➊krot➊nie
wielu	wie➊lu
wiemy	wie➊my
wiernych	wier➊nych
wierzy	wie➊rzy
więc	więc
więcej	wię➊cej
większa	więk➊sza
większą	więk➊szą
większe	więk➊sze
większego	więk➊sze➊go
większej	więk➊szej
większości	więk➊szo➊ści
większość	więk➊szość
większy	więk➊szy
większych	więk➊szych
większym	więk➊szym
więzienia	wię➊zie➊nia
więźniów	więź➊niów
winy	wi➊ny
Wirtembergii	Wir➊tem➊ber➊gii
wizerunek	wi➊ze➊ru➊nek
wizyta	wi➊zy➊ta
wizytą	wi➊zy➊tą
wizytę	wi➊zy➊tę
wizyty	wi➊zy➊ty
wkład	wkład
wkrótce	wkrót➊ce
Władimir	Wła➊di➊mir
władz	władz
władze	wła➊dze
władzę	wła➊dzę
władzy	wła➊dzy
własną	wła➊sną
własne	wła➊sne
własnego	wła➊sne➊go
własnej	wła➊snej
własny	wła➊sny
własnych	wła➊snych
własnym	wła➊snym
właściwie	wła➊ści➊wie
właśnie	wła➊śnie
Włoch	Włoch
Włochy	Wło➊chy
Włoszech	Wło➊szech
wniosek	wnio➊sek
wnioski	wnio➊ski
wniosków	wnio➊sków
wniosku	wnio➊sku
wobec	wo➊bec
wody	wo➊dy
wojennych	wo➊jen➊nych
wojna	woj➊na
wojną	woj➊ną
wojnę	woj➊nę
wojnie	woj➊nie
wojny	woj➊ny
wojsk	wojsk
wojska	woj➊ska
wojskowej	woj➊sko➊wej
wojskowych	woj➊sko➊wych
wokół	wo➊kół
Wolfgang	Wol➊fgang
Wolfganga	Wol➊fgan➊ga
woli	wo➊li
wolnego	wol➊ne➊go
wolno	wol➊no
wolności	wol➊no➊ści
wolność	wol➊ność
wolnych	wol➊nych
wówczas	wów➊czas
wpływ	wpływ
wpływów	wpły➊wów
wpływu	wpły➊wu
wpływy	wpły➊wy
wprawdzie	wpraw➊dzie
wprowadzenia	wpro➊wa➊dze➊nia
wprowadzenie	wpro➊wa➊dze➊nie
wprowadzić	wpro➊wa➊dzić
wraz	wraz
wrażenie	wra➊że➊nie
wreszcie	wresz➊cie
wręcz	wręcz
września	wrze➊śnia
wrześniu	wrze➊śniu
wschodnich	wschod➊nich
wschodniej	wschod➊niej
wschodzie	wscho➊dzie
wschód	wschód
wskazał	wska➊zał
wskazują	wska➊zu➊ją
wskazuje	wska➊zu➊je
wskaźnik	wskaź➊nik
wskutek	wsku➊tek
wsparcia	wspar➊cia
wsparcie	wspar➊cie
wspomina	wspo➊mi➊na
wspólną	wspól➊ną
wspólne	wspól➊ne
wspólnego	wspól➊ne➊go
wspólnej	wspól➊nej
wspólnie	wspól➊nie
wspólnota	wspól➊no➊ta
wspólnoty	wspól➊no➊ty
wspólny	wspól➊ny
wspólnych	wspól➊nych
wspólnymi	wspól➊nymi
współpraca	współ➊pra➊ca
współpracę	współ➊pra➊cę
współpracy	współ➊pra➊cy
wszelkich	wszel➊kich
wszelkie	wszel➊kie
wszędzie	wszę➊dzie
wszyscy	wszy➊scy
wszystkich	wszyst➊kich
wszystkie	wszyst➊kie
wszystkiego	wszyst➊kie➊go
wszystkim	wszyst➊kim
wszystko	wszyst➊ko
wśród	wśród
wtedy	wte➊dy
wtorek	wto➊rek
wyborach	wy➊bo➊rach
wyborami	wy➊bo➊ra➊mi
wyborców	wy➊bor➊ców
wyborcy	wy➊bor➊cy
wyborcza	wy➊bor➊cza
wyborczą	wy➊bor➊czą
wyborczej	wy➊bor➊czej
wyborczy	wy➊bor➊czy
wyborczych	wy➊bor➊czych
wyborów	wy➊bo➊rów
wyboru	wy➊bo➊ru
wybory	wy➊bo➊ry
wybór	wy➊bór
wybrany	wy➊bra➊ny
wybuchu	wy➊bu➊chu
wychodzi	wy➊cho➊dzi
wydaje	wy➊da➊je
wydania	wy➊da➊nia
wydanie	wy➊da➊nie
wydaniu	wy➊da➊niu
wydarzenia	wy➊da➊rze➊nia
wydarzeń	wy➊da➊rzeń
wydatki	wy➊dat➊ki
wydatków	wy➊dat➊ków
wygląda	wy➊glą➊da
wyjaśnia	wy➊ja➊śnia
wyjaśnić	wy➊ja➊śnić
wyjaśnienia	wy➊ja➊śnie➊nia
wyjątkowo	wy➊jąt➊ko➊wo
wyjścia	wyj➊ścia
wyjść	wyjść
wyklucza	wy➊klu➊cza
wykorzystać	wy➊ko➊rzy➊stać
wyłącznie	wy➊łącz➊nie
wymaga	wy➊ma➊ga
wymiany	wy➊mia➊ny
wymiar	wy➊miar
wymiaru	wy➊mia➊ru
wynik	wy➊nik
wynika	wy➊ni➊ka
wyniki	wy➊ni➊ki
wynikiem	wy➊ni➊kiem
wyników	wy➊ni➊ków
wyniku	wy➊ni➊ku
wynosi	wy➊no➊si
wyobrazić	wy➊obra➊zić
wypadek	wy➊pa➊dek
wypadku	wy➊pad➊ku
wypędzeń	wy➊pę➊dzeń
wypędzonych	wy➊pę➊dzo➊nych
Wypędzonych	Wy➊pę➊dzo➊nych
wypowiada	wy➊po➊wia➊da
wypowiedzi	wy➊po➊wie➊dzi
wypowiedział	wy➊po➊wie➊dział
wypowiedź	wy➊po➊wiedź
wyraził	wy➊ra➊ził
wyraźnie	wy➊raź➊nie
wyraża	wy➊ra➊ża
wyrok	wy➊rok
wyroku	wy➊ro➊ku
wysoki	wy➊so➊ki
wysokich	wy➊so➊kich
wysokie	wy➊so➊kie
wysoko	wy➊so➊ko
wysokości	wy➊so➊ko➊ści
wystarczy	wy➊star➊czy
wystawa	wy➊sta➊wa
wystawę	wy➊sta➊wę
wystawy	wy➊sta➊wy
wystąpienia	wy➊stą➊pie➊nia
wystąpienie	wy➊stą➊pie➊nie
wystąpieniu	wy➊stą➊pie➊niu
wywiad	wy➊wiad
wywiadu	wy➊wia➊du
wywiadzie	wy➊wia➊dzie
wywołała	wy➊wo➊ła➊ła
wywołuje	wy➊wo➊łu➊je
wyższe	wyż➊sze
względem	wzglę➊dem
względu	wzglę➊du
wziąć	wziąć
wzrosła	wzro➊sła
wzrosły	wzro➊sły
wzrost	wzrost
wzrostu	wzro➊stu
wzrósł	wzrósł
XVI	XVI
zaangażowania	za➊an➊ga➊żo➊wa➊nia
zaangażowanie	za➊an➊ga➊żo➊wa➊nie
zaapelował	za➊ape➊lo➊wał
zachodnich	za➊chod➊nich
zachodniej	za➊chod➊niej
zachodu	za➊cho➊du
Zachodu	Za➊cho➊du
zachodzie	za➊cho➊dzie
zachować	za➊cho➊wać
zachowania	za➊cho➊wa➊nia
zachowanie	za➊cho➊wa➊nie
zachód	za➊chód
Zachód	Za➊chód
zaczął	za➊czął
zaczyna	za➊czy➊na
zadania	za➊da➊nia
zadanie	za➊da➊nie
zadaniem	za➊da➊niem
zadań	za➊dań
zadłużenia	za➊dłu➊że➊nia
zadłużenie	za➊dłu➊że➊nie
zagłady	za➊gła➊dy
zagranicy	za➊gra➊ni➊cy
zagranicznej	za➊gra➊nicz➊nej
zagranicznych	za➊gra➊nicz➊nych
zagraża	za➊gra➊ża
zagrożenia	za➊gro➊że➊nia
zagrożenie	za➊gro➊że➊nie
zagrożeniem	za➊gro➊że➊niem
zainteresowania	za➊in➊te➊re➊so➊wa➊nia
zainteresowanie	za➊in➊te➊re➊so➊wa➊nie
zająć	za➊jąć
zajmują	zaj➊mu➊ją
zajmuje	zaj➊mu➊je
zakaz	za➊kaz
zakazu	za➊ka➊zu
zakładów	za➊kła➊dów
zakończenia	za➊koń➊cze➊nia
zakończenie	za➊koń➊cze➊nie
zakończeniu	za➊koń➊cze➊niu
zakresie	za➊kre➊sie
zaledwie	za➊le➊d➊wie
zależy	za➊le➊ży
założenia	za➊ło➊że➊nia
zamach	za➊mach
zamachów	za➊ma➊chów
zamachu	za➊ma➊chu
zamachy	za➊ma➊chy
zamian	za➊mian
zamiast	za➊miast
zamierza	za➊mie➊rza
zamierzają	za➊mie➊rza➊ją
zamieszcza	za➊miesz➊cza
zanim	za➊nim
zapewnia	za➊pew➊nia
zapewnić	za➊pew➊nić
zapewnił	za➊pew➊nił
zapłacić	za➊pła➊cić
zapobiec	za➊po➊biec
zapowiada	za➊po➊wia➊da
zapowiedział	za➊po➊wie➊dział
zapowiedziała	za➊po➊wie➊dzia➊ła
zapowiedź	za➊po➊wiedź
zaraz	za➊raz
zarazem	za➊ra➊zem
zarówno	za➊rów➊no
zarządu	za➊rzą➊du
zarzuca	za➊rzu➊ca
zarzucił	za➊rzu➊cił
zarzut	za➊rzut
zarzuty	za➊rzu➊ty
zasad	za➊sad
zasady	za➊sa➊dy
zasadzie	za➊sa➊dzie
zasiłku	za➊sił➊ku
zastanawia	za➊sta➊na➊wia
zaś	zaś
zatem	za➊tem
zatrudnienia	za➊trud➊nie➊nia
zatrudnionych	za➊trud➊nio➊nych
zaufania	za➊ufa➊nia
zaufanie	za➊ufa➊nie
zauważa	za➊uwa➊ża
zawiera	za➊wie➊ra
zawodowe	za➊wo➊do➊we
zawodowego	za➊wo➊do➊we➊go
zawodowy	za➊wo➊do➊wy
zawodowych	za➊wo➊do➊wych
zawodu	za➊wo➊du
zawsze	za➊wsze
zaznacza	za➊zna➊cza
zaznaczył	za➊zna➊czył
zazwyczaj	za➊zwy➊czaj
zbrodni	zbrod➊ni
zbrojnych	zbroj➊nych
zbyt	zbyt
zdaje	zda➊je
zdania	zda➊nia
zdanie	zda➊nie
zdaniem	zda➊niem
zdecydował	zde➊cy➊do➊wał
zdecydowanie	zde➊cy➊do➊wa➊nie
ZDF	ZDF
zdjęcia	zdję➊cia
zdrowia	zdro➊wia
zespół	ze➊spół
zewnątrz	ze➊wnątrz
zgadza	zga➊dza
zginęło	zgi➊nę➊ło
zgodnie	zgod➊nie
zgoła	zgo➊ła
zieloni	zie➊lo➊ni
Zieloni	Zie➊lo➊ni
zielonych	zie➊lo➊nych
Zielonych	Zie➊lo➊nych
ziemi	zie➊mi
zimnej	zim➊nej
zjazd	zjazd
zjednoczenia	zjed➊no➊cze➊nia
zjednoczone	zjed➊no➊czo➊ne
Zjednoczone	Zjed➊no➊czo➊ne
zjednoczonych	zjed➊no➊czo➊nych
Zjednoczonych	Zjed➊no➊czo➊nych
zjeździe	zjeź➊dzie
zlecenie	zle➊ce➊nie
złe	złe
zmarł	zmarł
zmian	zmian
zmiana	zmia➊na
zmianę	zmia➊nę
zmiany	zmia➊ny
zmieni	zmie➊ni
zmienia	zmie➊nia
zmienić	zmie➊nić
zmieniło	zmie➊ni➊ło
zna	zna
znaczenia	zna➊cze➊nia
znaczenie	zna➊cze➊nie
znaczeniu	zna➊cze➊niu
znacznie	znacz➊nie
znaczy	zna➊czy
znajdują	znaj➊du➊ją
znajduje	znaj➊du➊je
znajdzie	znaj➊dzie
znak	znak
znakiem	zna➊kiem
znalazł	zna➊lazł
znalazła	zna➊la➊zła
znalazły	zna➊la➊zły
znaleźć	zna➊leźć
znaleźli	zna➊leź➊li
znane	zna➊ne
znany	zna➊ny
znanych	zna➊nych
znowu	zno➊wu
znów	znów
zostać	zo➊stać
zostali	zo➊sta➊li
został	zo➊stał
została	zo➊sta➊ła
zostało	zo➊sta➊ło
zostały	zo➊sta➊ły
zostaną	zo➊sta➊ną
zostanie	zo➊sta➊nie
zresztą	zresz➊tą
zrezygnować	zre➊zy➊gno➊wać
zrobić	zro➊bić
zrozumiałe	zro➊zu➊mia➊łe
zrozumieć	zro➊zu➊mieć
zrozumienia	zro➊zu➊mie➊nia
zrozumienie	zro➊zu➊mie➊nie
zupełnie	zu➊peł➊nie
zwalczania	zwal➊cza➊nia
związane	zwią➊za➊ne
związanych	zwią➊za➊nych
związek	zwią➊zek
Związek	Zwią➊zek
związki	związ➊ki
związkowych	związ➊ko➊wych
związków	związ➊ków
związku	związ➊ku
zwierząt	zwie➊rząt
zwiększenia	zwięk➊sze➊nia
zwiększenie	zwięk➊sze➊nie
zwłaszcza	zwłasz➊cza
zwolenników	zwo➊len➊ni➊ków
zwraca	zwra➊ca
zwrot	zwrot
zwrócił	zwró➊cił
zwycięstwa	zwy➊cię➊stwa
zwycięstwo	zwy➊cię➊stwo
zwykle	zwy➊kle
zyski	zy➊ski
źle	źle
źródeł	źró➊deł
żaden	ża➊den
żadna	żad➊na
żadne	żad➊ne
żadnego	żad➊ne➊go
żadnej	żad➊nej
żadnych	żad➊nych
żadnym	żad➊nym
żąda	żą➊da
żądania	żą➊da➊nia
żeby	że➊by
żołnierze	żoł➊nie➊rze
żołnierzy	żoł➊nie➊rzy
życia	ży➊cia
życie	ży➊cie
życiu	ży➊ciu
żyć	żyć
żydów	ży➊dów
Żydów	Ży➊dów
żyją	ży➊ją
żyje	ży➊je
żywności	żyw➊no➊ści
