Form	Hyphenation

# SPDX-License-Identifier: Unicode-DFS-2016

абсолютно	аб➊со➊лют➊но
августа	ав➊гу➊ста
августе	ав➊гу➊сте
австрии	ав➊стрии
автомобилей	ав➊то➊мо➊би➊лей
автомобили	ав➊то➊мо➊би➊ли
автомобиля	ав➊то➊мо➊би➊ля
автомобиль	ав➊то➊мо➊биль
авторов	ав➊то➊ров
авторы	ав➊то➊ры
автор	ав➊тор
аварии	ава➊рии
авиакомпании	авиа➊ком➊па➊нии
агентства	агент➊ства
агентства	агентст➊ва
агентство	агент➊ство
агентство	агентст➊во
агентству	агент➊ству
агентству	агентст➊ву
адвокат	ад➊во➊кат
адресу	ад➊ре➊су
адрес	ад➊рес
администрации	ад➊ми➊ни➊стра➊ции
администрация	ад➊ми➊ни➊стра➊ция
азии	азии
активистов	ак➊ти➊ви➊стов
активисты	ак➊ти➊ви➊сты
активно	ак➊тив➊но
активность	ак➊тив➊ность
акции	ак➊ции
акций	ак➊ций
акцию	ак➊цию
акция	ак➊ция
академии	ака➊де➊мии
алма	ал➊ма
александра	алек➊сан➊дра
александр	алек➊сандр
алексей	алек➊сей
аль	аль
альянса	аль➊ян➊са
альянс	аль➊янс
америка	аме➊ри➊ка
американцев	аме➊ри➊кан➊цев
американцы	аме➊ри➊кан➊цы
американская	аме➊ри➊кан➊ская
американские	аме➊ри➊кан➊ские
американский	аме➊ри➊кан➊ский
американским	аме➊ри➊кан➊ским
американских	аме➊ри➊кан➊ских
американского	аме➊ри➊кан➊ско➊го
американской	аме➊ри➊кан➊ской
америке	аме➊ри➊ке
америки	аме➊ри➊ки
ангела	ан➊ге➊ла
ангелы	ан➊ге➊лы
андрей	ан➊дрей
андрей	анд➊рей
аналитики	ана➊ли➊ти➊ки
анатолий	ана➊то➊лий
апреле	ап➊ре➊ле
апреля	ап➊ре➊ля
армении	ар➊ме➊нии
армии	ар➊мии
армия	ар➊мия
ареста	аре➊ста
ареста	арес➊та
арест	арест
асада	аса➊да
ассоциации	ас➊со➊циа➊ции
атмосферу	ат➊мо➊сфе➊ру
атомной	атом➊ной
афганистана	аф➊га➊ни➊ста➊на
афганистане	аф➊га➊ни➊ста➊не
афганистан	аф➊га➊ни➊стан
африки	аф➊ри➊ки
аэропорту	аэро➊пор➊ту
аэс	аэс
баварии	ба➊ва➊рии
базе	ба➊зе
базы	ба➊зы
барак	ба➊рак
банк	банк
банка	бан➊ка
банки	бан➊ки
банков	бан➊ков
беженцев	бе➊жен➊цев
беларуси	бе➊ла➊ру➊си
беларусь	бе➊ла➊русь
белоруссии	бе➊ло➊рус➊сии
белорусская	бе➊ло➊рус➊ская
белорусские	бе➊ло➊рус➊ские
белорусский	бе➊ло➊рус➊ский
белорусских	бе➊ло➊рус➊ских
белорусского	бе➊ло➊рус➊ско➊го
белорусской	бе➊ло➊рус➊ской
без	без
безопасности	без➊оп➊ас➊но➊сти
безопасность	без➊оп➊ас➊ность
безработицы	без➊ра➊бо➊ти➊цы
безработных	без➊ра➊бот➊ных
безусловно	без➊ус➊лов➊но
беларусi	бе➊ла➊ру➊сi
бельгии	бель➊гии
бен	бен
берлина	бер➊ли➊на
берлине	бер➊ли➊не
берлин	бер➊лин
берлинского	бер➊лин➊ско➊го
берлинской	бер➊лин➊ской
берлускони	бер➊лус➊ко➊ни
бизнеса	биз➊не➊са
бизнес	биз➊нес
бишкеке	биш➊ке➊ке
благодаря	бла➊го➊да➊ря
ближайшее	бли➊жай➊шее
ближайшие	бли➊жай➊шие
ближнем	ближ➊нем
ближнем	бли➊жнем
блока	бло➊ка
блок	блок
более	бо➊лее
борис	бо➊рис
бороться	бо➊роть➊ся
боевиков	бое➊ви➊ков
боевых	бое➊вых
большая	боль➊шая
больше	боль➊ше
большей	боль➊шей
большие	боль➊шие
большим	боль➊шим
большинства	боль➊шин➊ства
большинства	боль➊шинст➊ва
большинстве	боль➊шин➊стве
большинстве	боль➊шинст➊ве
большинство	боль➊шин➊ство
большинство	боль➊шинст➊во
больших	боль➊ших
большого	боль➊шо➊го
большое	боль➊шое
большой	боль➊шой
большую	боль➊шую
бонне	бон➊не
борту	бор➊ту
борьба	борь➊ба
борьба	бо➊рьба
борьбе	борь➊бе
борьбе	бо➊рьбе
борьбу	борь➊бу
борьбу	бо➊рьбу
борьбы	борь➊бы
борьбы	бо➊рьбы
британский	бри➊тан➊ский
британского	бри➊тан➊ско➊го
брюсселе	брюс➊се➊ле
брюссель	брюс➊сель
будем	бу➊дем
будет	бу➊дет
будущего	бу➊ду➊ще➊го
будущее	бу➊ду➊щее
будущем	бу➊ду➊щем
будут	бу➊дут
буша	бу➊ша
будто	буд➊то
буквально	бук➊валь➊но
буквально	бу➊ква➊льно
бундесвера	бун➊дес➊ве➊ра
бундестага	бун➊дес➊та➊га
бундестаге	бун➊дес➊та➊ге
бундестаг	бун➊дес➊таг
буш	буш
бывает	бы➊ва➊ет
была	бы➊ла
были	бы➊ли
было	бы➊ло
быстрее	бы➊стрее
быстрее	быст➊рее
быстро	бы➊стро
быстро	быст➊ро
бывшего	быв➊ше➊го
бывшей	быв➊шей
бывший	быв➊ший
бывших	быв➊ших
был	был
быть	быть
бюро	бю➊ро
бюджета	бюд➊же➊та
бюджета	бю➊дже➊та
бюджет	бюд➊жет
бюджет	бю➊джет
вадим	ва➊дим
валюты	ва➊лю➊ты
вариант	ва➊ри➊ант
вашингтона	ва➊шинг➊то➊на
вашингтона	ва➊шин➊гто➊на
вашингтоне	ва➊шинг➊то➊не
вашингтоне	ва➊шин➊гто➊не
вашингтон	ва➊шинг➊тон
вашингтон	ва➊шин➊гтон
важно	важ➊но
важно	ва➊жно
важным. важным	важ➊ным. ва➊жным
вальтер	валь➊тер
вам	вам
ван	ван
вас	вас
введение	вве➊де➊ние
введения	вве➊де➊ния
ввести	вве➊сти
ввп	ввп
вдвое	вдвое
вдруг	вдруг
ведет	ве➊дет
ведомства	ве➊дом➊ства
ведомства	ве➊домст➊ва
ведомство	ве➊дом➊ство
ведомство	ве➊домст➊во
ведущие	ве➊ду➊щие
ведущих	ве➊ду➊щих
ведут	ве➊дут
века	ве➊ка
великобритании	ве➊ли➊ко➊бри➊та➊нии
великобритания	ве➊ли➊ко➊бри➊та➊ния
вероятно	ве➊ро➊ят➊но
вестервелле	ве➊стер➊вел➊ле
вести	ве➊сти
вечером	ве➊че➊ром
вещи	ве➊щи
ведь	ведь
венгрии. венгрии	вен➊грии. венг➊рии
вернуть	вер➊нуть
вернуться	вер➊нуть➊ся
версии	вер➊сии
верховной	вер➊хов➊ной
верховный	вер➊хов➊ный
весь	весь
весьма	весь➊ма
весьма	ве➊сьма
взгляд	взгляд
взрыва	взры➊ва
взрыв	взрыв
взять	взять
виде	ви➊де
видео	ви➊део
видимо	ви➊ди➊мо
видит	ви➊дит
видов	ви➊дов
виду	ви➊ду
видят	ви➊дят
визита	ви➊зи➊та
визитом	ви➊зи➊том
визит	ви➊зит
вину	ви➊ну
виталий	ви➊та➊лий
вице	ви➊це
вид	вид
виктора	вик➊то➊ра
виктор	вик➊тор
вильгельм	виль➊гельм
вклад	вклад
включая	вклю➊чая
владимира	вла➊ди➊ми➊ра
владимир	вла➊ди➊мир
властей	вла➊стей
властей	влас➊тей
власти	вла➊сти
власти	влас➊ти
властями	вла➊стя➊ми
властями	влас➊тя➊ми
властям	вла➊стям
властям	влас➊тям
власть	власть
влияние	влия➊ние
влияния	влия➊ния
вместе	вме➊сте
вместе	вмес➊те
вместо	вме➊сто
вместо	вмес➊то
вне	вне
внести	вне➊сти
внести	внес➊ти
внешней	внеш➊ней
внешней	вне➊шней
внимание	вни➊ма➊ние
внимания	вни➊ма➊ния
вновь	вновь
внутреннего	вну➊трен➊не➊го
внутренних	вну➊трен➊них
внутри	вну➊три
вовсе	во➊все
воды	во➊ды
военно	во➊ен➊но
военного	во➊ен➊но➊го
военнослужащих	во➊ен➊но➊слу➊жа➊щих
военной	во➊ен➊ной
военную	во➊ен➊ную
военные	во➊ен➊ные
военный	во➊ен➊ный
военных	во➊ен➊ных
вокруг	во➊круг
вообще	во➊об➊ще
вооружений	во➊ору➊же➊ний
вооруженных	во➊ору➊жен➊ных
вопреки	во➊пре➊ки
вопроса	во➊про➊са
вопросам	во➊про➊сам
вопросах	во➊про➊сах
вопросе	во➊про➊се
вопросов	во➊про➊сов
вопросом	во➊про➊сом
вопросу	во➊про➊су
вопросы	во➊про➊сы
вопрос	во➊прос
восемь	во➊семь
возможно	воз➊мож➊но
возможностей	воз➊мож➊но➊стей
возможности	воз➊мож➊но➊сти
возможность	воз➊мож➊ность
возможных	воз➊мож➊ных
возникает	воз➊ни➊ка➊ет
возраста	воз➊рас➊та
возрасте	воз➊рас➊те
война	вой➊на
войне	вой➊не
войну	вой➊ну
войны	вой➊ны
войска	вой➊ска
войск	войск
волна	вол➊на
волне	вол➊не
волны	вол➊ны
вольфганг	вольф➊ганг
востоке	вос➊то➊ке
восточной	вос➊точ➊ной
воскресенье	вос➊кре➊се➊нье
восьми. восьми	вось➊ми. во➊сьми
вот	вот
впечатление	впе➊чат➊ле➊ние
впервые	впер➊вые
вполне	впол➊не
впредь	впредь
впрочем	впро➊чем
врачи	вра➊чи
времена	вре➊ме➊на
временем	вре➊ме➊нем
времени	вре➊ме➊ни
времен	вре➊мен
временно	вре➊мен➊но
время	вре➊мя
вроде	вро➊де
вряд	вряд
все	все
всё	всё
всегда	все➊гда
всегда	всег➊да
всеми	все➊ми
всемирного	все➊мир➊но➊го
всему	все➊му
всего	все➊го
всей	всей
всем	всем
всех	всех
вскоре	вско➊ре
встреча	встре➊ча
встрече	встре➊че
встречи	встре➊чи
встречу	встре➊чу
вступление	вступ➊ле➊ние
вступления	вступ➊ле➊ния
всю	всю
вся	вся
всяком	вся➊ком
вто	вто
вторая	вто➊рая
второго	вто➊ро➊го
второе	вто➊рое
второй	вто➊рой
втором	вто➊ром
вторых	вто➊рых
вторник	втор➊ник
входит	вхо➊дит
входят	вхо➊дят
въезд	въезд
выборами	вы➊бо➊ра➊ми
выборам	вы➊бо➊рам
выборах	вы➊бо➊рах
выборов	вы➊бо➊ров
выборы	вы➊бо➊ры
выбор	вы➊бор
выводу	вы➊во➊ду
выводы	вы➊во➊ды
вывод	вы➊вод
выглядит	вы➊гля➊дит
вызвало	вы➊зва➊ло
вызывает	вы➊зы➊ва➊ет
вызывают	вы➊зы➊ва➊ют
вынуждены	вы➊ну➊жде➊ны
вынуждены	вы➊нуж➊де➊ны
вынужден	вы➊ну➊жден
вынужден	вы➊нуж➊ден
выполнять	вы➊пол➊нять
выразили	вы➊ра➊зи➊ли
выразил	вы➊ра➊зил
вырос	вы➊рос
высказался	вы➊ска➊зал➊ся
высказывания	вы➊ска➊зы➊ва➊ния
высокие	вы➊со➊кие
высокий	вы➊со➊кий
высокой	вы➊со➊кой
выставка	вы➊став➊ка
выставки	вы➊став➊ки
выступает	вы➊сту➊па➊ет
выступают	вы➊сту➊па➊ют
выступая	вы➊сту➊пая
выступили	вы➊сту➊пи➊ли
выступил	вы➊сту➊пил
выступления	вы➊ступ➊ле➊ния
выхода	вы➊хо➊да
выходит	вы➊хо➊дит
выход	вы➊ход
выше	вы➊ше
вышел	вы➊шел
вышла	вы➊шла
вышли	вы➊шли
выяснилось	вы➊яс➊ни➊лось
выяснить	вы➊яс➊нить
выйти	вый➊ти
выпуск	вы➊пуск
газа	га➊за
газета	га➊зе➊та
газете	га➊зе➊те
газеты	га➊зе➊ты
газет	га➊зет
газопровода	га➊зо➊про➊во➊да
газ	газ
газпрома	газ➊про➊ма
газпром	газ➊пром
гамбурге	гам➊бур➊ге
где	где
гдр	гдр
генерал	ге➊не➊рал
генерального	ге➊не➊раль➊но➊го
генеральный	ге➊не➊раль➊ный
геннадий	ген➊на➊дий
германией	гер➊ма➊ни➊ей
германии	гер➊ма➊нии
германию	гер➊ма➊нию
германия	гер➊ма➊ния
германо	гер➊ма➊но
германского	гер➊ман➊ско➊го
германской	гер➊ман➊ской
германской	гер➊манс➊кой
герхард	гер➊хард
гибели	ги➊бе➊ли
гидо	ги➊до
глава	гла➊ва
главе	гла➊ве
главой	гла➊вой
главу	гла➊ву
главы	гла➊вы
глаза	гла➊за
глав	глав
главная	глав➊ная
главного	глав➊но➊го
главное	глав➊ное
главной	глав➊ной
главный	глав➊ный
главным	глав➊ным
главных	глав➊ных
говорили	го➊во➊ри➊ли
говорил	го➊во➊рил
говорит	го➊во➊рит
говорится	го➊во➊рит➊ся
говорить	го➊во➊рить
говоря	го➊во➊ря
говорят	го➊во➊рят
года	го➊да
годам	го➊дам
годах	го➊дах
годов	го➊дов
годом	го➊дом
году	го➊ду
годы	го➊ды
голову	го➊ло➊ву
голоса	го➊ло➊са
голосование	го➊ло➊со➊ва➊ние
голосования	го➊ло➊со➊ва➊ния
голосов	го➊ло➊сов
голос	го➊лос
гораздо	го➊раз➊до
города	го➊ро➊да
городах	го➊ро➊дах
городе	го➊ро➊де
городов	го➊ро➊дов
город	го➊род
городской	го➊род➊ской
гостей	го➊стей
государства	го➊су➊дар➊ства
государства	го➊су➊дарст➊ва
государственного	го➊су➊дар➊ствен➊но➊го
государственного	го➊су➊дарст➊вен➊но➊го
государственной	го➊су➊дар➊ствен➊ной
государственной	го➊су➊дарст➊вен➊ной
государственные	го➊су➊дар➊ствен➊ные
государственные	го➊су➊дарст➊вен➊ные
государственный	го➊су➊дар➊ствен➊ный
государственный	го➊су➊дарст➊вен➊ный
государственных	го➊су➊дар➊ствен➊ных
государственных	го➊су➊дарст➊вен➊ных
государство	го➊су➊дар➊ство
государство	го➊су➊дарст➊во
государством	го➊су➊дар➊ством
государством	го➊су➊дарст➊вом
государству	го➊су➊дар➊ству
государству	го➊су➊дарст➊ву
государств	го➊су➊дарств
готова	го➊то➊ва
готовы	го➊то➊вы
готов	го➊тов
готовности	го➊тов➊но➊сти
готовность	го➊тов➊ность
год	год
госсекретарь	гос➊се➊кре➊тарь
гражданам	гра➊жда➊нам
гражданам	граж➊да➊нам
граждане	гра➊жда➊не
граждане	граж➊да➊не
граждан	гра➊ждан
граждан	граж➊дан
гражданских	гра➊ждан➊ских
гражданских	граж➊дан➊ских
гражданского	гра➊ждан➊ско➊го
гражданского	граж➊дан➊ско➊го
гражданской	гра➊ждан➊ской
гражданской	граж➊дан➊ской
границе	гра➊ни➊це
границей	гра➊ни➊цей
границу	гра➊ни➊цу
границы	гра➊ни➊цы
границ	гра➊ниц
греции	гре➊ции
грозит	гро➊зит
грузии	гру➊зии
группа	груп➊па
группе	груп➊пе
группировки	груп➊пи➊ров➊ки
группу	груп➊пу
группы	груп➊пы
групп	групп
гуманитарной	гу➊ма➊ни➊тар➊ной
гуща	гу➊ща
гэта	гэ➊та
давать	да➊вать
дает	да➊ет
даже	да➊же
далеко	да➊ле➊ко
далее	да➊лее
дали	да➊ли
дают	да➊ют
давление	дав➊ле➊ние
давления	дав➊ле➊ния
давно	дав➊но
дал	дал
дальше	даль➊ше
данном	дан➊ном
данные	дан➊ные
данный	дан➊ный
данным	дан➊ным
данных	дан➊ных
дать	дать
два	два
две	две
движение	дви➊же➊ние
движения	дви➊же➊ния
двое	двое
двумя	дву➊мя
двух	двух
декабре	де➊ка➊бре
декабре	де➊каб➊ре
декабря	де➊ка➊бря
декабря	де➊каб➊ря
дела	де➊ла
делает	де➊ла➊ет
делают	де➊ла➊ют
делам	де➊лам
делать	де➊лать
деле	де➊ле
делегации	де➊ле➊га➊ции
дело	де➊ло
делом	де➊лом
делу	де➊лу
демократических	де➊мо➊кра➊ти➊че➊ских
демократического	де➊мо➊кра➊ти➊че➊ско➊го
демократической	де➊мо➊кра➊ти➊че➊ской
демократии	де➊мо➊кра➊тии
демократия	де➊мо➊кра➊тия
демократов	де➊мо➊кра➊тов
демократы	де➊мо➊кра➊ты
демонстрации	де➊мон➊стра➊ции
демонстрации	де➊монс➊тра➊ции
демонстрации	де➊монст➊ра➊ции
демонстрантов	де➊мон➊стран➊тов
демонстрантов	де➊монс➊тран➊тов
демонстрантов	де➊монст➊ран➊тов
денег	де➊нег
депутата	де➊пу➊та➊та
депутатов	де➊пу➊та➊тов
депутаты	де➊пу➊та➊ты
депутат	де➊пу➊тат
десяти	де➊ся➊ти
десятки	де➊сят➊ки
десятков	де➊сят➊ков
десять	де➊сять
детей	де➊тей
дети	де➊ти
дефицит	де➊фи➊цит
деятельности	де➊я➊тель➊но➊сти
деятельностью	де➊я➊тель➊но➊стью
деятельность	де➊я➊тель➊ность
действительно	дей➊стви➊тель➊но
действительно	дейс➊тви➊тель➊но
действительно	дейст➊ви➊тель➊но
действительности	дей➊стви➊тель➊но➊сти
действительности	дейс➊тви➊тель➊но➊сти
действительности	дейст➊ви➊тель➊но➊сти
действие	дей➊ствие
действие	дейст➊вие
действий	дей➊ствий
действий	дейст➊вий
действия	дей➊ствия
действия	дейст➊вия
действовать	дей➊ство➊вать
действовать	дейст➊во➊вать
действует действует	дей➊ству➊ет дейст➊ву➊ет
дел	дел
день	день
деньги	день➊ги
джон	джон
джордж	джордж
директора	ди➊рек➊то➊ра
директор	ди➊рек➊тор
диалога	диа➊ло➊га
диалог	диа➊лог
дискуссии	дис➊кус➊сии
дискуссия	дис➊кус➊сия
для	для
дмитрий	дмит➊рий
дмитрий	дми➊трий
дмитрия	дмит➊рия
дмитрия	дми➊трия
дней	дней
днем	днем
дни	дни
дня	дня
днях	днях
добавил	до➊ба➊вил
добиться	до➊бить➊ся
доверие	до➊ве➊рие
доверия	до➊ве➊рия
довольно	до➊воль➊но
договора	до➊го➊во➊ра
договоренности	до➊го➊во➊рен➊но➊сти
договорились	до➊го➊во➊ри➊лись
договориться	до➊го➊во➊рить➊ся
договор	до➊го➊вор
доказать	до➊ка➊зать
документа	до➊ку➊мен➊та
документе	до➊ку➊мен➊те
документов	до➊ку➊мен➊тов
документы	до➊ку➊мен➊ты
документ	до➊ку➊мент
долю	до➊лю
доля	до➊ля
дома	до➊ма
доме	до➊ме
домов	до➊мов
домой	до➊мой
дополнительные	до➊пол➊ни➊тель➊ные
допустить	до➊пу➊стить
дороги	до➊ро➊ги
достаточно	до➊ста➊точ➊но
достижения	до➊сти➊же➊ния
достичь	до➊стичь
доступ	до➊ступ
доходов	до➊хо➊дов
доходы	до➊хо➊ды
докладе	до➊кла➊де
докладе	док➊ла➊де
доклад	до➊клад
доклад	док➊лад
долго	дол➊го
долгое	дол➊гое
должен	дол➊жен
доллара	дол➊ла➊ра
долларов	дол➊ла➊ров
должна	долж➊на
должна	дол➊жна
должно	долж➊но
должно	дол➊жно
должности	долж➊но➊сти
должности	дол➊жнос➊ти
должность	долж➊ность
должность	дол➊жность
должны	долж➊ны
должны	дол➊жны
дом	дом
донбассе	дон➊бас➊се
друга	дру➊га
другая	дру➊гая
другими	дру➊ги➊ми
другие	дру➊гие
другим	дру➊гим
других	дру➊гих
другого	дру➊го➊го
другое	дру➊гое
другой	дру➊гой
другом	дру➊гом
другую	дру➊гую
друзей	дру➊зей
друг	друг
думаю	ду➊маю
душанбе	ду➊шан➊бе
евгений	ев➊ге➊ний
евреев	ев➊ре➊ев
евро	ев➊ро
еврозоны	ев➊ро➊зо➊ны
еврокомиссии	ев➊ро➊ко➊мис➊сии
еврокомиссия	ев➊ро➊ко➊мис➊сия
европа	ев➊ро➊па
европарламента	ев➊ро➊пар➊ла➊мен➊та
европе	ев➊ро➊пе
европейские	ев➊ро➊пей➊ские
европейские	ев➊ро➊пейс➊кие
европейский	ев➊ро➊пей➊ский
европейский	ев➊ро➊пейс➊кий
европейским	ев➊ро➊пей➊ским
европейским	ев➊ро➊пейс➊ким
европейских	ев➊ро➊пей➊ских
европейских	ев➊ро➊пейс➊ких
европейского	ев➊ро➊пей➊ско➊го
европейского	ев➊ро➊пейс➊ко➊го
европейской	ев➊ро➊пей➊ской
европейской	ев➊ро➊пейс➊кой
европейцев	ев➊ро➊пей➊цев
европейцы	ев➊ро➊пей➊цы
европой	ев➊ро➊пой
европу	ев➊ро➊пу
европы	ев➊ро➊пы
евросоюза	ев➊ро➊со➊ю➊за
евросоюзе	ев➊ро➊со➊ю➊зе
евросоюзом	ев➊ро➊со➊ю➊зом
евросоюз	ев➊ро➊со➊юз
его	его
едва	ед➊ва
единого	еди➊но➊го
единой	еди➊ной
единственный	един➊ствен➊ный
единственный	единст➊вен➊ный
ежегодно	еже➊год➊но
ежедневно	еже➊днев➊но
елена	еле➊на
ему	ему
если	ес➊ли
естественно	ес➊те➊ст➊вен➊но
есть	есть
ецб	ецб
еще	еще
ещё	ещё
ждать	ждать
ждут	ждут
желание	же➊ла➊ние
женщина	жен➊щи➊на
женщины	жен➊щи➊ны
женщин	жен➊щин
жертвами	жерт➊ва➊ми
жертв	жертв
живет	жи➊вет
животных	жи➊вот➊ных
живут	жи➊вут
жители	жи➊те➊ли
жителей	жи➊те➊лей
жизни	жиз➊ни
жизни	жи➊зни
жизнь	жизнь
жить	жить
жуков	жу➊ков
журнала	жур➊на➊ла
журналиста	жур➊на➊ли➊ста
журналистами	жур➊на➊ли➊ста➊ми
журналистам	жур➊на➊ли➊стам
журналистов	жур➊на➊ли➊стов
журналисты	жур➊на➊ли➊сты
журналист	жур➊на➊лист
журнал	жур➊нал
зависимости	за➊ви➊си➊мо➊сти
зависит	за➊ви➊сит
задача	за➊да➊ча
задачей	за➊да➊чей
задачи	за➊да➊чи
задержаны	за➊дер➊жа➊ны
задержан	за➊дер➊жан
задержанных	за➊дер➊жан➊ных
заключается	за➊клю➊ча➊ет➊ся
заключение	за➊клю➊че➊ние
заключения	за➊клю➊че➊ния
заключенных	за➊клю➊чен➊ных
закона	за➊ко➊на
законодательства	за➊ко➊но➊да➊тель➊ства
законодательство	за➊ко➊но➊да➊тель➊ство
законопроект	за➊ко➊но➊про➊ект
законов	за➊ко➊нов
законом	за➊ко➊ном
закону	за➊ко➊ну
законы	за➊ко➊ны
закон	за➊кон
зале	за➊ле
заложников	за➊лож➊ни➊ков
заместитель	за➊ме➊сти➊тель
заметил	за➊ме➊тил
заметно	за➊мет➊но
занимает	за➊ни➊ма➊ет
занимается	за➊ни➊ма➊ет➊ся
занимаются	за➊ни➊ма➊ют➊ся
заниматься	за➊ни➊мать➊ся
заранее	за➊ра➊нее
заседание	за➊се➊да➊ние
заседании	за➊се➊да➊нии
заседания	за➊се➊да➊ния
затем	за➊тем
зато	за➊то
зачастую	за➊ча➊стую
зачастую	за➊час➊тую
зачем	за➊чем
защита	за➊щи➊та
защите	за➊щи➊те
защиту	за➊щи➊ту
защиты	за➊щи➊ты
запада	за➊па➊да
западе	за➊па➊де
западом	за➊па➊дом
запад	за➊пад
западной	за➊пад➊ной
западные	за➊пад➊ные
западных	за➊пад➊ных
запрет	за➊прет
зарплаты	зар➊пла➊ты
заявление	за➊яв➊ле➊ние
заявлении	за➊яв➊ле➊нии
заявления	за➊яв➊ле➊ния
заявила	за➊яви➊ла
заявили	за➊яви➊ли
заявил	за➊явил
звучит	зву➊чит
здание	зда➊ние
здания	зда➊ния
здесь	здесь
здоровья	здо➊ро➊вья
здравоохранения	здра➊во➊ох➊ра➊не➊ния
зеленые	зе➊ле➊ные
зеленых	зе➊ле➊ных
земель	зе➊мель
земле	зем➊ле
земли	зем➊ли
знаем	зна➊ем
знает	зна➊ет
значение	зна➊че➊ние
значительно	зна➊чи➊тель➊но
значит	зна➊чит
знают	зна➊ют
знак	знак
знать	знать
знаю	знаю
зоне	зо➊не
зоны	зо➊ны
зрения	зре➊ния
иванов	ива➊нов
игра	иг➊ра
играет	иг➊ра➊ет
играют	иг➊ра➊ют
играть	иг➊рать
игры	иг➊ры
игорь	игорь
игр	игр
идти	ид➊ти
идеи	идеи
идет	идет
идёт	идёт
идею	идею
идея	идея
идут	идут
избежать	из➊бе➊жать
избирателей	из➊би➊ра➊те➊лей
избирательной	из➊би➊ра➊тель➊ной
избирательных	из➊би➊ра➊тель➊ных
известно	из➊вест➊но
известный	из➊вест➊ный
известных	из➊вест➊ных
известного	из➊вест➊но➊го
издание	из➊да➊ние
издания	из➊да➊ния
изменений	из➊ме➊не➊ний
изменения	из➊ме➊не➊ния
изменить	из➊ме➊нить
израиля	из➊ра➊и➊ля
израиль	из➊ра➊иль
или	или
имеет	име➊ет
имели	име➊ли
имена	име➊на
имени	име➊ни
имеют	име➊ют
именно	имен➊но
иметь	иметь
ими	ими
имя	имя
инвестиции	ин➊ве➊сти➊ции
инвестиций	ин➊ве➊сти➊ций
инвесторов	ин➊ве➊сто➊ров
индии	ин➊дии
интеграции	ин➊те➊гра➊ции
интервью	ин➊тер➊вью
интернета	ин➊тер➊не➊та
интернете	ин➊тер➊не➊те
интернет	ин➊тер➊нет
интерфакс	ин➊тер➊факс
интересах	ин➊те➊ре➊сах
интересов	ин➊те➊ре➊сов
интересы	ин➊те➊ре➊сы
интерес	ин➊те➊рес
интересно	ин➊те➊рес➊но
информационное	ин➊фор➊ма➊ци➊он➊ное
информации	ин➊фор➊ма➊ции
информацию	ин➊фор➊ма➊цию
информация	ин➊фор➊ма➊ция
иначе	ина➊че
инициативе	ини➊циа➊ти➊ве
инициативу	ини➊циа➊ти➊ву
инициативы	ини➊циа➊ти➊вы
иногда	ино➊гда
иногда	иног➊да
иностранные	ино➊стран➊ные
иностранным	ино➊стран➊ным
иностранных	ино➊стран➊ных
иностранцев	ино➊стран➊цев
иной	иной
института	ин➊сти➊ту➊та
институт	ин➊сти➊тут
ирака	ира➊ка
ираке	ира➊ке
ирана	ира➊на
ирак	ирак
иран	иран
искать	ис➊кать
исключает	ис➊клю➊ча➊ет
исключено	ис➊клю➊че➊но
исключительно	ис➊клю➊чи➊тель➊но
искусства	ис➊кус➊ства
искусство	ис➊кус➊ство
испании	ис➊па➊нии
использование	ис➊поль➊зо➊ва➊ние
использования	ис➊поль➊зо➊ва➊ния
использовать	ис➊поль➊зо➊вать
используют	ис➊поль➊зу➊ют
исследование	ис➊сле➊до➊ва➊ние
исследований	ис➊сле➊до➊ва➊ний
исследования	ис➊сле➊до➊ва➊ния
истории	ис➊то➊рии
историю	ис➊то➊рию
история	ис➊то➊рия
источники	ис➊точ➊ни➊ки
источников	ис➊точ➊ни➊ков
источник	ис➊точ➊ник
иск	иск
исламское	ис➊лам➊ское
италии	ита➊лии
итак	итак
итогам	ито➊гам
итоге	ито➊ге
итоги	ито➊ги
июле	ию➊ле
июля	ию➊ля
июне	ию➊не
июня	ию➊ня
йорке	йор➊ке
кабинета	ка➊би➊не➊та
каддафи	кад➊да➊фи
кажется	ка➊жет➊ся
казалось	ка➊за➊лось
казахстана	ка➊зах➊ста➊на
казахстане	ка➊зах➊ста➊не
казахстан	ка➊зах➊стан
какая	ка➊кая
какие	ка➊кие
каким	ка➊ким
каких	ка➊ких
какое	ка➊кое
какой	ка➊кой
каком	ка➊ком
какую	ка➊кую
касается	ка➊са➊ет➊ся
катастрофы	ка➊та➊стро➊фы
катастрофы	ка➊тас➊тро➊фы
качества	ка➊че➊ства
качества	ка➊чест➊ва
качестве	ка➊че➊стве
качестве	ка➊чест➊ве
качество	ка➊че➊ство
качество	ка➊чест➊во
кавказе	кав➊ка➊зе
каждая	каж➊дая
каждого	каж➊до➊го
каждой	каж➊дой
каждый	каж➊дый
как	как
кампании	кам➊па➊нии
кандидата	кан➊ди➊да➊та
кандидатов	кан➊ди➊да➊тов
кандидат	кан➊ди➊дат
канцлера	канц➊ле➊ра
канцлером	канц➊ле➊ром
канцлер	канц➊лер
картины	кар➊ти➊ны
карл	карл
квартале	квар➊та➊ле
кгб	кгб
кельне	кель➊не
керри	кер➊ри
киева	ки➊е➊ва
киеве	ки➊е➊ве
киев	ки➊ев
километров	ки➊ло➊мет➊ров
кино	ки➊но
китае	ки➊тае
китай	ки➊тай
китая	ки➊тая
киргизии	кир➊ги➊зии
класса	клас➊са
клаус	клаус
клиентов	кли➊ен➊тов
климата	кли➊ма➊та
клуба	клу➊ба
клуб	клуб
кндр	кндр
книга	кни➊га
книги	кни➊ги
книг	книг
кнр	кнр
кого	ко➊го
количества	ко➊ли➊че➊ства
количества	ко➊ли➊чест➊ва
количество	ко➊ли➊че➊ство
количества	ко➊ли➊чест➊ва
колонии	ко➊ло➊нии
команда	ко➊ман➊да
команды	ко➊ман➊ды
кому	ко➊му
конец	ко➊нец
конечно	ко➊неч➊но
конечном	ко➊неч➊ном
кореи	ко➊реи
косово	ко➊со➊во
которая	ко➊то➊рая
которого	ко➊то➊ро➊го
которому	ко➊то➊ро➊му
которое	ко➊то➊рое
которой	ко➊то➊рой
котором	ко➊то➊ром
которую	ко➊то➊рую
которыми	ко➊то➊ры➊ми
которые	ко➊то➊рые
который	ко➊то➊рый
которым	ко➊то➊рым
которых	ко➊то➊рых
коалиции	коа➊ли➊ции
коалиция	коа➊ли➊ция
когда	ког➊да
когда	ко➊гда
коллега	кол➊ле➊га
коллеги	кол➊ле➊ги
коллег	кол➊лег
комментарии	ком➊мен➊та➊рии
комментарий	ком➊мен➊та➊рий
комментирует	ком➊мен➊ти➊ру➊ет
комитета	ко➊ми➊те➊та
комитет	ко➊ми➊тет
комиссар	ко➊мис➊сар
комиссии	ко➊мис➊сии
комиссия	ко➊мис➊сия
компании	ком➊па➊нии
компаний	ком➊па➊ний
компания	ком➊па➊ния
конкретные	кон➊крет➊ные
конкретные	конк➊рет➊ные
конкретных. конкретных	кон➊крет➊ных. конк➊рет➊ных
конкурса	кон➊кур➊са
контакты	кон➊так➊ты
конференции	кон➊фе➊рен➊ции
конференция	кон➊фе➊рен➊ция
конфликта	кон➊флик➊та
конфликте	кон➊флик➊те
конфликтов	кон➊флик➊тов
конфликт	кон➊фликт
конца	кон➊ца
конце	кон➊це
концерна	кон➊цер➊на
концерн	кон➊церн
концов	кон➊цов
концу	кон➊цу
конституции	кон➊сти➊ту➊ции
контингента	кон➊тин➊ген➊та
контролем	кон➊тро➊лем
контроля	кон➊тро➊ля
контроль	кон➊троль
конъюнктуры	конъ➊юнк➊ту➊ры
корреспондента	кор➊ре➊спон➊ден➊та
корреспондента	кор➊рес➊пон➊ден➊та
корреспонденту	кор➊ре➊спон➊ден➊ту
корреспонденту	кор➊рес➊пон➊ден➊ту
корреспондент	кор➊ре➊спон➊дент
корреспондент	кор➊рес➊пон➊дент
коррупцией	кор➊руп➊ци➊ей
коррупции	кор➊руп➊ции
крайне	край➊не
крайней	край➊ней
красно	крас➊но
кремля	крем➊ля
кремль	кремль
кризиса	кри➊зи➊са
кризис	кри➊зис
критике	кри➊ти➊ке
критики	кри➊ти➊ки
критику	кри➊ти➊ку
кроме	кро➊ме
крупнейших	круп➊ней➊ших
крупные	круп➊ные
крупных	круп➊ных
крыма	кры➊ма
крыму	кры➊му
крым	крым
кстати	кста➊ти
кто	кто
куда	ку➊да
купить	ку➊пить
культуры	куль➊ту➊ры
курса	кур➊са
курс	курс
лагеря	ла➊ге➊ря
латвии	лат➊вии
летом	ле➊том
легко	лег➊ко
лет	лет
летнего	лет➊не➊го
летний	лет➊ний
либо	ли➊бо
ливии	ли➊вии
лидера	ли➊де➊ра
лидеров	ли➊де➊ров
лидером	ли➊де➊ром
лидеры	ли➊де➊ры
лидер	ли➊дер
линии	ли➊нии
лица	ли➊ца
лишения	ли➊ше➊ния
литвы	лит➊вы
лиц	лиц
лицо	ли➊цо
лично	лич➊но
личности	лич➊но➊сти
лишь	лишь
лондоне	лон➊до➊не
лукашенко	лу➊ка➊шен➊ко
лучше	луч➊ше
любви	люб➊ви
любой	лю➊бой
любом	лю➊бом
любые	лю➊бые
людей	лю➊дей
люди	лю➊ди
людям	лю➊дям
людьми	людь➊ми
мало	ма➊ло
марина	ма➊ри➊на
марок	ма➊рок
материалов	ма➊те➊риа➊лов
материалы	ма➊те➊риа➊лы
машина	ма➊ши➊на
машину	ма➊ши➊ну
машины	ма➊ши➊ны
машин	ма➊шин
мае	мае
майне	май➊не
марта	мар➊та
марте	мар➊те
мартин	мар➊тин
массового	мас➊со➊во➊го
массовой	мас➊со➊вой
массовые	мас➊со➊вые
массовых	мас➊со➊вых
мая	мая
мвд	мвд
мвф	мвф
менее	ме➊нее
меня	ме➊ня
мере	ме➊ре
мероприятий	ме➊ро➊прия➊тий
мероприятия	ме➊ро➊прия➊тия
меры	ме➊ры
места	ме➊ста
местах	ме➊стах
месте	ме➊сте
место	ме➊сто
месяца	ме➊ся➊ца
месяцев	ме➊ся➊цев
месяцы	ме➊ся➊цы
месяц	ме➊сяц
медведева	мед➊ве➊де➊ва
медведев	мед➊ве➊дев
между	меж➊ду
международная	меж➊ду➊на➊род➊ная
международного	меж➊ду➊на➊род➊но➊го
международное	меж➊ду➊на➊род➊ное
международной	меж➊ду➊на➊род➊ной
международном	меж➊ду➊на➊род➊ном
международные	меж➊ду➊на➊род➊ные
международный	меж➊ду➊на➊род➊ный
международным	меж➊ду➊на➊род➊ным
международных	меж➊ду➊на➊род➊ных
меньше	мень➊ше
меньшей	мень➊шей
мер	мер
меркель	мер➊кель
мест	мест
местные	мест➊ные
местных	мест➊ных
метро	мет➊ро
метров	мет➊ров
мигрантов	ми➊гран➊тов
мигрантов	миг➊ран➊тов
мида	ми➊да
милиции	ми➊ли➊ции
минимум	ми➊ни➊мум
министерства	ми➊ни➊стер➊ства
министерства	ми➊нис➊терст➊ва
министерстве	ми➊ни➊стер➊стве
министерстве	ми➊нис➊терст➊ве
министерство	ми➊ни➊стер➊ство
министерство	ми➊нис➊терст➊во
министра	ми➊ни➊стра
министра	ми➊нист➊ра
министров	ми➊ни➊стров
министров	ми➊нист➊ров
министром	ми➊ни➊стром
министром	ми➊нист➊ром
министры	ми➊ни➊стры
министры	ми➊нист➊ры
министр	ми➊нистр
минут	ми➊нут
мира	ми➊ра
мире	ми➊ре
миру	ми➊ру
митинг	ми➊тинг
михаила	ми➊хаи➊ла
михаил	ми➊ха➊ил
михаэль	ми➊ха➊эль
мид	мид
миллиарда	мил➊ли➊ар➊да
миллиардов	мил➊ли➊ар➊дов
миллиона	мил➊лио➊на
миллиона	мил➊ли➊она
миллионов	мил➊лио➊нов
миллионов	мил➊ли➊он➊ов
мин	мин
минск	минск
минска	мин➊ска
минска	минс➊ка
минска	ми➊нска
минске	мин➊ске
минске	минс➊ке
минска	ми➊нска
мир	мир
мирного	мир➊но➊го
мирных	мир➊ных
мирового	ми➊ро➊во➊го
мировой	ми➊ро➊вой
мировых	ми➊ро➊вых
миссии	мис➊сии
млн	млн
млрд	млрд
мне	мне
мнением	мне➊ни➊ем
мнениями	мне➊ни➊я➊ми
мнение	мне➊ние
мнению	мне➊нию
мнения	мне➊ния
многие	мно➊гие
многим	мно➊гим
многих	мно➊гих
множество	мно➊же➊ство
множество	мно➊жес➊тво
множество	мно➊жест➊во
много	мно➊го
многочисленные	мно➊го➊чис➊лен➊ные
многое	мно➊гое
многом	мно➊гом
могу	мо➊гу
могут	мо➊гут
модели	мо➊де➊ли
модель	мо➊дель
моей	мо➊ей
можем	мо➊жем
может	мо➊жет
молодежи	мо➊ло➊де➊жи
молодежь	мо➊ло➊дежь
молодой	мо➊ло➊дой
молодые	мо➊ло➊дые
молодых	мо➊ло➊дых
момента	мо➊мен➊та
момент	мо➊мент
море	мо➊ре
моря	мо➊ря
московского	мо➊сков➊ско➊го
московского	мос➊ков➊ско➊го
мог	мог
могла	мог➊ла
могли	мог➊ли
могло	мог➊ло
можно	мож➊но
мои	мои
мой	мой
мол	мол
молдавии	мол➊да➊вии
москва	моск➊ва
москва	мо➊сква
москва	мос➊ква
москве	моск➊ве
москве	мо➊скве
москве	мос➊кве
москвой	моск➊вой
московой	мо➊сковой
москвой	мос➊квой
москву	моск➊ву
москву	мо➊скву
москву	мос➊кву
москвы	моск➊вы
москвы	мо➊сквы
москвы	мос➊квы
моя	моя
музее	му➊зее
музей	му➊зей
музея	му➊зея
музыка	му➊зы➊ка
музыки	му➊зы➊ки
мусульман	му➊суль➊ман
мужчины	муж➊чи➊ны
мужчин	муж➊чин
мюнхене	мюн➊хе➊не
мяч	мяч
наблюдатели	на➊блю➊да➊те➊ли
наблюдателей	на➊блю➊да➊те➊лей
наверное	на➊вер➊ное
надежда	на➊де➊жда
надежда	на➊деж➊да
надежду	на➊де➊жду
надежду	на➊деж➊ду
надежды	на➊де➊жды
надежды	на➊деж➊ды
надеются	на➊де➊ют➊ся
надеется	на➊де➊ет➊ся
надо	на➊до
назад	на➊зад
назвала	на➊зва➊ла
назвали	на➊зва➊ли
названием	на➊зва➊ни➊ем
название	на➊зва➊ние
назвал	на➊звал
назвать	на➊звать
называемой	на➊зы➊вае➊мой
называемых	на➊зы➊вае➊мых
называет	на➊зы➊ва➊ет
называется	на➊зы➊ва➊ет➊ся
называют	на➊зы➊ва➊ют
наказание	на➊ка➊за➊ние
наказания	на➊ка➊за➊ния
накануне	на➊ка➊ну➊не
наконец	на➊ко➊нец
наличие	на➊ли➊чие
налогов	на➊ло➊гов
намерена	на➊ме➊ре➊на
намерении	на➊ме➊ре➊нии
намерено	на➊ме➊ре➊но
намерены	на➊ме➊ре➊ны
намерен	на➊ме➊рен
нами	на➊ми
намного	на➊мно➊го
написал	на➊пи➊сал
напоминает	на➊по➊ми➊на➊ет
напомнил	на➊по➊мнил
напомнил	на➊пом➊нил
напомним	на➊по➊мним
напомним	на➊пом➊ним
народа	на➊ро➊да
народу	на➊ро➊ду
народ	на➊род
народного	на➊род➊но➊го
народной	на➊род➊ной
нарушение	на➊ру➊ше➊ние
нарушений	на➊ру➊ше➊ний
нарушения	на➊ру➊ше➊ния
наряду	на➊ря➊ду
население	на➊се➊ле➊ние
населения	на➊се➊ле➊ния
насилия	на➊си➊лия
насколько	на➊сколь➊ко
настоящее	на➊стоя➊щее
настоящий	на➊стоя➊щий
настолько	на➊столь➊ко
наталья	на➊та➊лья
нато	на➊то
находились	на➊хо➊ди➊лись
находился	на➊хо➊дил➊ся
находится	на➊хо➊дит➊ся
находятся	на➊хо➊дят➊ся
национал	на➊ци➊о➊нал
национального	на➊цио➊наль➊но➊го
национальной	на➊цио➊наль➊ной
национальный	на➊цио➊наль➊ный
национальных	на➊цио➊наль➊ных
начала	на➊ча➊ла
началась	на➊ча➊лась
начале	на➊ча➊ле
начали	на➊ча➊ли
начались	на➊ча➊лись
начало	на➊ча➊ло
началом	на➊ча➊лом
началось	на➊ча➊лось
начал	на➊чал
начался	на➊чал➊ся
начальник	на➊чаль➊ник
начать	на➊чать
начинает	на➊чи➊на➊ет
начинается	на➊чи➊на➊ет➊ся
начинают	на➊чи➊на➊ют
начиная	на➊чи➊ная
наша	на➊ша
наше	на➊ше
нашего	на➊ше➊го
нашей	на➊шей
наши	на➊ши
нашим	на➊шим
наших	на➊ших
нашли	на➊шли
нашу	на➊шу
над	над
наиболее	наи➊бо➊лее
найти	най➊ти
нам	нам
наоборот	на➊обо➊рот
нападение	на➊па➊де➊ние
нападения	на➊па➊де➊ния
направлении	на➊прав➊ле➊нии
например	на➊при➊мер
напротив	на➊про➊тив
наркотиков	нар➊ко➊ти➊ков
нас	нас
науки	нау➊ки
науки	нау➊ки
наш	наш
невозможно	не➊воз➊мож➊но
него	не➊го
недавно	не➊дав➊но
неделе	не➊де➊ле
недели	не➊де➊ли
неделю	не➊де➊лю
недель	не➊дель
недовольство	не➊до➊воль➊ство
недовольство	не➊до➊вольст➊во
независимости	не➊за➊ви➊си➊мо➊сти
независимость	не➊за➊ви➊си➊мость
независимые	не➊за➊ви➊си➊мые
независимых	не➊за➊ви➊си➊мых
некоторые	не➊ко➊то➊рые
некоторых	не➊ко➊то➊рых
нельзя	нель➊зя
нельзя	не➊льзя
немало	не➊ма➊ло
немедленно	не➊мед➊лен➊но
немецкая	не➊мец➊кая
немецкие	не➊мец➊кие
немецкий	не➊мец➊кий
немецким	не➊мец➊ким
немецких	не➊мец➊ких
немецкого	не➊мец➊ко➊го
немецкому	не➊мец➊ко➊му
немецкое	не➊мец➊кое
немецкой	не➊мец➊кой
немецком	не➊мец➊ком
нему	не➊му
непосредственно	не➊по➊сред➊ствен➊но
непосредственно	не➊по➊средст➊вен➊но
нередко	не➊ред➊ко
несет	не➊сет
несмотря	не➊смот➊ря
недостаточно	не➊до➊ста➊точ➊но
нее	нее
неё	неё
ней	ней
нем	нем
немцев	нем➊цев
немцы	нем➊цы
немного	не➊мно➊го
необходимо	не➊об➊хо➊ди➊мо
необходимости	не➊об➊хо➊ди➊мо➊сти
необходимость	не➊об➊хо➊ди➊мость
необходимые	не➊об➊хо➊ди➊мые
неоднократно	не➊од➊но➊крат➊но
неожиданно	не➊ожи➊дан➊но
нескольких	не➊сколь➊ких
несколько	не➊сколь➊ко
нет	нет
нефти	неф➊ти
нефти	не➊фти
нефть	нефть
нибудь	ни➊будь
ниже	ни➊же
никаких	ни➊ка➊ких
никакого	ни➊ка➊ко➊го
никакой	ни➊ка➊кой
никак	ни➊как
николай	ни➊ко➊лай
никогда	ни➊ког➊да
никогда	ни➊ко➊гда
никто	ни➊кто
ними	ни➊ми
ничего	ни➊че➊го
ним	ним
них	них
новая	но➊вая
нового	но➊во➊го
новому	но➊во➊му
новости	но➊во➊сти
новое	но➊вое
новой	но➊вой
новом	но➊вом
новую	но➊вую
новые	но➊вые
новый	но➊вый
новым	но➊вым
новых	но➊вых
номер	но➊мер
ноябре	ноя➊бре
ноября	ноя➊бря
ночь	ночь
нпо	нпо
нравится	нра➊вит➊ся
нуждается	ну➊жда➊ет➊ся
нуждается	нуж➊да➊ет➊ся
нужен	ну➊жен
нужна	нуж➊на
нужно	нуж➊но
нужны	нуж➊ны
ныне	ны➊не
нынешнего	ны➊неш➊не➊го
нынешней	ны➊неш➊ней
нынешнем	ны➊неш➊нем
нынешний	ны➊неш➊ний
нью	нью
обвинение	об➊ви➊не➊ние
обвинения	об➊ви➊не➊ния
обвинил	об➊ви➊нил
обвиняют	об➊ви➊ня➊ют
обзор	об➊зор
обладает	об➊ла➊да➊ет
области	об➊ла➊сти
области	об➊лас➊ти
обмена	об➊ме➊на
обмен	об➊мен
обнаружили	об➊на➊ру➊жи➊ли
образование	об➊ра➊зо➊ва➊ние
образования	об➊ра➊зо➊ва➊ния
образом	об➊ра➊зом
обращение	об➊ра➊ще➊ние
обсе	обсе
обсудить	об➊су➊дить
обсуждения	об➊су➊жде➊ния
обсуждения	об➊суж➊де➊ния
общая	об➊щая
общего	об➊ще➊го
общества	об➊ще➊ства
общества	об➊щест➊ва
обществе	об➊ще➊стве
обществе	об➊щест➊ве
общественно	об➊ще➊ствен➊но
обществвенно	об➊ществ➊вен➊но
общественного	об➊ще➊ствен➊но➊го
общественного	об➊щест➊вен➊но➊го
общественности	об➊ще➊ствен➊но➊сти
общественности	об➊щест➊вен➊нос➊ти
общественной	об➊ще➊ствен➊ной
общественной	об➊щест➊вен➊ной
общественных	об➊ще➊ствен➊ных
общественных	об➊щест➊вен➊ных
общество	об➊ще➊ство
общество	об➊щест➊во
общей	об➊щей
общем	об➊щем
общий	об➊щий
оба	оба
обама	оба➊ма
обамы	оба➊мы
обе	обе
обеих	обе➊их
обеспечения	обес➊пе➊че➊ния
обеспечить	обес➊пе➊чить
обороны	обо➊ро➊ны
оборот	обо➊рот
обратились	об➊ра➊ти➊лись
обратился	об➊ра➊тил➊ся
объявила	объ➊яви➊ла
объявили	объ➊яви➊ли
объявил	объ➊яв➊ил
объяснил	объ➊яс➊нил
объяснить	объ➊яс➊нить
объясняет	объ➊яс➊ня➊ет
объясняется	объ➊яс➊ня➊ет➊ся
объединение	объ➊еди➊не➊ние
объединения	объ➊еди➊не➊ния
объектов	объ➊ек➊тов
объем	объ➊ем
обычно	обыч➊но
обязательно	обя➊за➊тель➊но
обязанности	обя➊зан➊но➊сти
огня	ог➊ня
ограничения	огра➊ни➊че➊ния
одна	од➊на
однако	од➊на➊ко
одни	од➊ни
одним	од➊ним
одно	од➊но
одного	од➊но➊го
одному	од➊но➊му
одновременно	од➊но➊вре➊мен➊но
одной	од➊ной
одном	од➊ном
одну	од➊ну
один	один
ожидает	ожи➊да➊ет
ожидается	ожи➊да➊ет➊ся
ожидают	ожи➊да➊ют
ожидать	ожи➊дать
означает	озна➊ча➊ет
окажется	ока➊жет➊ся
оказалась	ока➊за➊лась
оказались	ока➊за➊лись
оказалось	ока➊за➊лось
оказался	ока➊зал➊ся
оказать	ока➊зать
оказаться	ока➊зать➊ся
оказывается	ока➊зы➊ва➊ет➊ся
оказывать	ока➊зы➊вать
около	око➊ло
окончания	окон➊ча➊ния
окончательно	окон➊ча➊тель➊но
окружающей	окру➊жа➊ю➊щей
октябре	ок➊тя➊бре
октябре	ок➊тяб➊ре
октября	ок➊тя➊бря
октября	ок➊тяб➊ря
олег	олег
ольга	оль➊га
она	она
они	они
оно	оно
оон	оон
оппозиционной	оп➊по➊зи➊ци➊он➊ной
оппозиционных	оп➊по➊зи➊ци➊он➊ных
оппозиции	оп➊по➊зи➊ции
оппозиция	оп➊по➊зи➊ция
опасаются	опа➊са➊ют➊ся
опасения	опа➊се➊ния
опасности	опас➊но➊сти
опасность	опас➊ность
операции	опе➊ра➊ции
операция	опе➊ра➊ция
опроса	опро➊са
опрошенных	опро➊шен➊ных
опрос	опрос
опубликованном	опуб➊ли➊ко➊ван➊ном
опыт	опыт
опять	опять
организаторов	ор➊га➊ни➊за➊то➊ров
организаторы	ор➊га➊ни➊за➊то➊ры
организацией	ор➊га➊ни➊за➊ци➊ей
организации	ор➊га➊ни➊за➊ции
организаций	ор➊га➊ни➊за➊ций
организацию	ор➊га➊ни➊за➊цию
организация	ор➊га➊ни➊за➊ция
органов	ор➊га➊нов
органы	ор➊га➊ны
оружием	ору➊жи➊ем
оружие	ору➊жие
оружия	ору➊жия
освободить	осво➊бо➊дить
освобождения	осво➊бо➊жде➊ния
освобождения	осво➊бож➊де➊ния
осенью	осе➊нью
осетии	осе➊тии
основании	ос➊но➊ва➊нии
основания	ос➊но➊ва➊ния
основе	ос➊но➊ве
основная	ос➊нов➊ная
основной	ос➊нов➊ной
основном	ос➊нов➊ном
основные	ос➊нов➊ные
основных	ос➊нов➊ных
особенно	осо➊бен➊но
особо	осо➊бо
особое	осо➊бое
оставаться	оста➊вать➊ся
остается	оста➊ет➊ся
остались	оста➊лись
осталось	оста➊лось
останется	оста➊нет➊ся
остановить	оста➊но➊вить
остаются	оста➊ют➊ся
остаётся	оста➊ёт➊ся
остался	остал➊ся
остальные	осталь➊ные
остаться	остать➊ся
ответа	от➊ве➊та
ответил	от➊ве➊тил
ответить	от➊ве➊тить
отвечает	от➊ве➊ча➊ет
ответ	от➊вет
ответственности	от➊вет➊ствен➊но➊сти
ответственности	от➊ветст➊вен➊нос➊ти
ответственность	от➊вет➊ствен➊ность
ответственность	от➊ветст➊вен➊ность
отличие	от➊ли➊чие
отменить	от➊ме➊нить
отметила	от➊ме➊ти➊ла
отметил	от➊ме➊тил
отметить	от➊ме➊тить
отмечает	от➊ме➊ча➊ет
отмечается	от➊ме➊ча➊ет➊ся
отмечают	от➊ме➊ча➊ют
относительно	от➊но➊си➊тель➊но
относится	от➊но➊сит➊ся
относятся	от➊но➊сят➊ся
отношениях	от➊но➊ше➊ни➊ях
отношение	от➊но➊ше➊ние
отношении	от➊но➊ше➊нии
отношений	от➊но➊ше➊ний
отношению	от➊но➊ше➊нию
отношения	от➊но➊ше➊ния
отнюдь	от➊нюдь
отрасли	от➊рас➊ли
отставки	от➊став➊ки
отставку	от➊став➊ку
отсутствие	от➊сут➊ствие
отдела	от➊де➊ла
отделения	от➊де➊ле➊ния
отдельные	от➊дель➊ные
отдельных	от➊дель➊ных
отец	отец
отказались	от➊ка➊за➊лись
отказался	от➊ка➊зал➊ся
отказаться	от➊ка➊зать➊ся
отказ	от➊каз
открытие	от➊кры➊тие
открытия	от➊кры➊тия
открыто	от➊кры➊то
открыть	от➊крыть
откуда	от➊ку➊да
официально	офи➊ци➊аль➊но
официального	офи➊ци➊аль➊но➊го
официальной	офи➊ци➊аль➊ной
официальные	офи➊ци➊аль➊ные
официальный	офи➊ци➊аль➊ный
официальным	офи➊ци➊аль➊ным
официальных	офи➊ци➊аль➊ных
охране	охра➊не
охраны	охра➊ны
оценкам	оцен➊кам
оценки	оцен➊ки
оценку	оцен➊ку
очевидно	оче➊вид➊но
очередной	оче➊ред➊ной
очередь	оче➊редь
очень	очень
павел	па➊вел
падение	па➊де➊ние
падения	па➊де➊ния
пакет	па➊кет
палаты	па➊ла➊ты
палестинцев	па➊ле➊стин➊цев
памяти	па➊мя➊ти
память	па➊мять
париже	па➊ри➊же
париж	па➊риж
пару	па➊ру
пасе	па➊се
парламента	пар➊ла➊мен➊та
парламенте	пар➊ла➊мен➊те
парламент	пар➊ла➊мент
парламентские	пар➊ла➊мент➊ские
парламентских	пар➊ла➊мент➊ских
парламентской	пар➊ла➊мент➊ской
партии	пар➊тии
партий	пар➊тий
партию	пар➊тию
партия	пар➊тия
партнеров	парт➊не➊ров
пассажиров	пас➊са➊жи➊ров
период	пе➊ри➊од
петер	пе➊тер
петербурге	пе➊тер➊бур➊ге
печати	пе➊ча➊ти
печать	пе➊чать
первая	пер➊вая
первого	пер➊во➊го
первое	пер➊вое
первой	пер➊вой
первом	пер➊вом
первую	пер➊вую
первые	пер➊вые
первый	пер➊вый
первым	пер➊вым
первых	пер➊вых
перспективе	пер➊спек➊ти➊ве
перспективы	пер➊спек➊ти➊вы
переговорах	пе➊ре➊го➊во➊рах
переговоров	пе➊ре➊го➊во➊ров
переговоры	пе➊ре➊го➊во➊ры
передает	пе➊ре➊да➊ет
передачи	пе➊ре➊да➊чи
переселенцев	пе➊ре➊се➊лен➊цев
перед	пе➊ред
петр	петр
питания	пи➊та➊ния
пишет	пи➊шет
письма	пись➊ма
письмо	пись➊мо
плана	пла➊на
плане	пла➊не
планеты	пла➊не➊ты
планирует	пла➊ни➊ру➊ет
планируется	пла➊ни➊ру➊ет➊ся
планов	пла➊нов
планы	пла➊ны
платить	пла➊тить
план	план
плохо	пло➊хо
площади	пло➊ща➊ди
площадь	пло➊щадь
победа	по➊бе➊да
победу	по➊бе➊ду
победы	по➊бе➊ды
поводом	по➊во➊дом
поводу	по➊во➊ду
повысить	по➊вы➊сить
повышение	по➊вы➊ше➊ние
повышения	по➊вы➊ше➊ния
погибли	по➊гиб➊ли
погибших	по➊гиб➊ших
пожалуй	по➊жа➊луй
позиции	по➊зи➊ции
позицию	по➊зи➊цию
позиция	по➊зи➊ция
пока	по➊ка
показали	по➊ка➊за➊ли
показатели	по➊ка➊за➊те➊ли
показатель	по➊ка➊за➊тель
показать	по➊ка➊зать
показывает	по➊ка➊зы➊ва➊ет
показывают	по➊ка➊зы➊ва➊ют
покинуть	по➊ки➊нуть
поколения	по➊ко➊ле➊ния
полагает	по➊ла➊га➊ет
полагают	по➊ла➊га➊ют
поле	по➊ле
политика	по➊ли➊ти➊ка
политике	по➊ли➊ти➊ке
политики	по➊ли➊ти➊ки
политиков	по➊ли➊ти➊ков
политикой	по➊ли➊ти➊кой
политику	по➊ли➊ти➊ку
политическая	по➊ли➊ти➊че➊ская
политические	по➊ли➊ти➊че➊ские
политический	по➊ли➊ти➊че➊ский
политическим	по➊ли➊ти➊че➊ским
политических	по➊ли➊ти➊че➊ских
политического	по➊ли➊ти➊че➊ско➊го
политическое	по➊ли➊ти➊че➊ское
политической	по➊ли➊ти➊че➊ской
политическую	по➊ли➊ти➊че➊скую
политик	по➊ли➊тик
полицейских	по➊ли➊цей➊ских
полиции	по➊ли➊ции
полиция	по➊ли➊ция
политолог	по➊ли➊то➊лог
половина	по➊ло➊ви➊на
половине	по➊ло➊ви➊не
половиной	по➊ло➊ви➊ной
половины	по➊ло➊ви➊ны
положение	по➊ло➊же➊ние
положении	по➊ло➊же➊нии
положения	по➊ло➊же➊ния
получает	по➊лу➊ча➊ет
получается	по➊лу➊ча➊ет➊ся
получают	по➊лу➊ча➊ют
получат	по➊лу➊чат
получать	по➊лу➊чать
получение	по➊лу➊че➊ние
получения	по➊лу➊че➊ния
получила	по➊лу➊чи➊ла
получили	по➊лу➊чи➊ли
получил	по➊лу➊чил
получит	по➊лу➊чит
получить	по➊лу➊чить
помимо	по➊ми➊мо
поможет	по➊мо➊жет
помощи	по➊мо➊щи
помощью	по➊мо➊щью
помочь	по➊мочь
помощь	по➊мощь
понедельник	по➊не➊дель➊ник
понимают	по➊ни➊ма➊ют
понятно	по➊нят➊но
понять	по➊нять
пообещал	по➊обе➊щал
попасть	по➊пасть
попытка	по➊пыт➊ка
попытки	по➊пыт➊ки
пора	по➊ра
поражение	по➊ра➊же➊ние
поражения	по➊ра➊же➊ния
порошенко	по➊ро➊шен➊ко
порой	по➊рой
порядок	по➊ря➊док
порядка	по➊ряд➊ка
порядке	по➊ряд➊ке
посетителей	по➊се➊ти➊те➊лей
поскольку	по➊сколь➊ку
после	по➊сле
последнего	по➊след➊не➊го
последнее	по➊след➊нее
последние	по➊след➊ние
последний	по➊след➊ний
последним	по➊след➊ним
последних	по➊след➊них
последствий	по➊след➊ствий
последствия	по➊след➊ствия
посмотреть	по➊смот➊реть
посол	по➊сол
посольства	по➊соль➊ства
поста	по➊ста
поставить	по➊ста➊вить
поставок	по➊ста➊вок
поставки	по➊став➊ки
постепенно	по➊сте➊пен➊но
постоянно	по➊сто➊ян➊но
пострадавших	по➊стра➊дав➊ших
посту	по➊сту
потери	по➊те➊ри
потому	по➊то➊му
поток	по➊ток
потом	по➊том
потребителей	по➊тре➊би➊те➊лей
потребовал	по➊тре➊бо➊вал
похоже	по➊хо➊же
почему	по➊че➊му
почти	по➊чти
почты	по➊чты
появилась	по➊яви➊лась
появились	по➊яви➊лись
появился	по➊явил➊ся
пояснил	по➊яс➊нил
поясняет	по➊яс➊ня➊ет
под	под
подготовил	под➊го➊то➊вил
подготовке	под➊го➊тов➊ке
подготовки	под➊го➊тов➊ки
поддержали	под➊дер➊жа➊ли
поддержать	под➊дер➊жать
поддерживает	под➊дер➊жи➊ва➊ет
поддерживают	под➊дер➊жи➊ва➊ют
поддерживать	под➊дер➊жи➊вать
поддержка	под➊держ➊ка
поддержке	под➊держ➊ке
поддержки	под➊держ➊ки
поддержку	под➊держ➊ку
подписали	под➊пи➊са➊ли
подписал	под➊пи➊сал
подтвердил	под➊твер➊дил
подчеркивает	под➊чер➊ки➊ва➊ет
подчеркнула	под➊черк➊ну➊ла
подчеркнул	под➊черк➊нул
подозреваемых	по➊до➊зре➊вае➊мых
подобного	по➊доб➊но➊го
подобные	по➊доб➊ные
подобных	по➊доб➊ных
поездки	по➊езд➊ки
позволит	по➊зво➊лит
позволяет	по➊зво➊ля➊ет
позже	поз➊же
поздно	позд➊но
позднее	позд➊нее
пойдет	пой➊дет
пойти	пой➊ти
полгода	пол➊го➊да
полномочий	пол➊но➊мо➊чий
полномочия	пол➊но➊мо➊чия
полностью	пол➊но➊стью
полной	пол➊ной
полную	пол➊ную
полтора	пол➊то➊ра
пользу	поль➊зу
пользуется	поль➊зу➊ет➊ся
пользуются	поль➊зу➊ют➊ся
польша	поль➊ша
польше	поль➊ше
польши	поль➊ши
пор	пор
портал	пор➊тал
пост	пост
поэтому	по➊это➊му
права	пра➊ва
правам	пра➊вам
правила	пра➊ви➊ла
правило	пра➊ви➊ло
правительства	пра➊ви➊тель➊ства
правительства	пра➊ви➊тельст➊ва
правительстве. правительстве	пра➊ви➊тель➊стве. пра➊ви➊тельст➊ве
правительство	пра➊ви➊тель➊ство
правительство	пра➊ви➊тельст➊во
правительством	пра➊ви➊тель➊ством
правительством	пра➊ви➊тельст➊вом
правительству	пра➊ви➊тель➊ству
правительству	пра➊ви➊тельст➊ву
правительств	пра➊ви➊тельств
правил	пра➊вил
правильно	пра➊виль➊но
право	пра➊во
правовой	пра➊во➊вой
правозащитники	пра➊во➊за➊щит➊ни➊ки
правозащитников	пра➊во➊за➊щит➊ни➊ков
правоохранительных	пра➊во➊ох➊ра➊ни➊тель➊ных
правящей	пра➊вя➊щей
прав	прав
правда	прав➊да
правления	прав➊ле➊ния
праздник	празд➊ник
практике	прак➊ти➊ке
практически	прак➊ти➊че➊ски
пребывания	пре➊бы➊ва➊ния
превышает	пре➊вы➊ша➊ет
пределами	пре➊де➊ла➊ми
президента	пре➊зи➊ден➊та
президентом	пре➊зи➊ден➊том
президенту	пре➊зи➊ден➊ту
президенты	пре➊зи➊ден➊ты
президент	пре➊зи➊дент
президентских	пре➊зи➊дент➊ских
прекратить	пре➊кра➊тить
прекращения	пре➊кра➊ще➊ния
прекрасно	пре➊крас➊но
премии	пре➊мии
премию	пре➊мию
премия	пре➊мия
премьера	пре➊мье➊ра
премьер	пре➊мьер
преступлений	пре➊ступ➊ле➊ний
преступления	пре➊ступ➊ле➊ния
предвыборной	пред➊вы➊бор➊ной
преддверии	пред➊две➊рии
предполагается	пред➊по➊ла➊га➊ет➊ся
предпринимателей	пред➊при➊ни➊ма➊те➊лей
предприятие	пред➊прия➊тие
предприятий	пред➊прия➊тий
предприятия	пред➊прия➊тия
председателя	пред➊се➊да➊те➊ля
председателем	пред➊се➊да➊те➊лем
председатель	пред➊се➊да➊тель
представители	пред➊ста➊ви➊те➊ли
представителя	пред➊ста➊ви➊те➊ля
представителями	пред➊ста➊ви➊те➊ля➊ми
представителей	пред➊ста➊ви➊те➊лей
представитель	пред➊ста➊ви➊тель
представить	пред➊ста➊вить
представлены	пред➊став➊ле➊ны
представляет	пред➊став➊ля➊ет
представляют	пред➊став➊ля➊ют
предстоит	пред➊сто➊ит
предлагает	пред➊ла➊га➊ет
предлагают	пред➊ла➊га➊ют
предложение	пред➊ло➊же➊ние
предложения	пред➊ло➊же➊ния
предложил	пред➊ло➊жил
предоставить	пре➊до➊ста➊вить
предотвратить	пред➊от➊вра➊тить
предусматривает	пред➊у➊сма➊три➊ва➊ет
прежде	пре➊жде
прежде	преж➊де
прежнему	преж➊не➊му
преодолеть	пре➊одо➊леть
пресса	прес➊са
прессе	прес➊се
прессы	прес➊сы
пресс	пресс
при	при
прибыли	при➊бы➊ли
прибыль	при➊быль
приведет	при➊ве➊дет
привело	при➊ве➊ло
привести	при➊ве➊сти
привлечь	при➊влечь
приводит	при➊во➊дит
приговор	при➊го➊вор
придется	при➊дет➊ся
призвала	при➊зва➊ла
призвали	при➊зва➊ли
призвал	при➊звал
признал	при➊знал
признать	при➊знать
призывает	при➊зы➊ва➊ет
примеру	при➊ме➊ру
применение	при➊ме➊не➊ние
применения	при➊ме➊не➊ния
пример	при➊мер
примерно	при➊мер➊но
примет	при➊мет
принадлежит	при➊над➊ле➊жит
принимает	при➊ни➊ма➊ет
принимают	при➊ни➊ма➊ют
принимать	при➊ни➊мать
приняла	при➊ня➊ла
приняли	при➊ня➊ли
принятие	при➊ня➊тие
принятия	при➊ня➊тия
принято	при➊ня➊то
принял	при➊нял
принять	при➊нять
природы	при➊ро➊ды
присутствие	при➊сут➊ствие
приходится	при➊хо➊дит➊ся
причастности	при➊част➊но➊сти
причина	при➊чи➊на
причинам	при➊чи➊нам
причине	при➊чи➊не
причиной	при➊чи➊ной
причины	при➊чи➊ны
причин	при➊чин
пришли	при➊шли
пришлось	при➊шлось
принципе	прин➊ци➊пе
принцип	прин➊цип
причем	при➊чем
причём	при➊чём
про	про
проведение	про➊ве➊де➊ние
проведении	про➊ве➊де➊нии
проведения	про➊ве➊де➊ния
проведенного	про➊ве➊ден➊но➊го
провели	про➊ве➊ли
провести	про➊ве➊сти
провел	про➊вел
проверки	про➊вер➊ки
провинции	про➊вин➊ции
проводит	про➊во➊дит
проводить	про➊во➊дить
проводят	про➊во➊дят
проголосовали	про➊го➊ло➊со➊ва➊ли
программа	про➊грам➊ма
программе	про➊грам➊ме
программу	про➊грам➊му
программы	про➊грам➊мы
программ	про➊грамм
продажи	про➊да➊жи
продолжает	про➊дол➊жа➊ет
продолжается	про➊дол➊жа➊ет➊ся
продолжают	про➊дол➊жа➊ют
продолжать	про➊дол➊жать
продолжить	про➊дол➊жить
продуктов	про➊дук➊тов
продукты	про➊дук➊ты
продукции	про➊дук➊ции
прокуратура	про➊ку➊ра➊ту➊ра
прокуратуры	про➊ку➊ра➊ту➊ры
промышленности	про➊мыш➊лен➊но➊сти
просто	про➊сто
протеста	про➊те➊ста
протестов	про➊те➊стов
протесты	про➊те➊сты
против	про➊тив
противников	про➊тив➊ни➊ков
протяжении	про➊тя➊же➊нии
профессор	про➊фес➊сор
проходит	про➊хо➊дит
проходят	про➊хо➊дят
процента	про➊цен➊та
процентов	про➊цен➊тов
процент	про➊цент
процесса	про➊цес➊са
процессе	про➊цес➊се
процесс	про➊цесс
прошел	про➊шел
прошла	про➊шла
прошли	про➊шли
прошло	про➊шло
прошлого	про➊шло➊го
прошлой	про➊шлой
прошлом	про➊шлом
проблема	про➊бле➊ма
проблемами	про➊бле➊ма➊ми
проблемам	про➊бле➊мам
проблеме	про➊бле➊ме
проблемой	про➊бле➊мой
проблему	про➊бле➊му
проблемы	про➊бле➊мы
проблем	про➊блем
прогноз	про➊гноз
проекта	про➊ек➊та
проекте	про➊ек➊те
проектов	про➊ек➊тов
проекты	про➊ек➊ты
проект	про➊ект
производителей	про➊из➊во➊ди➊те➊лей
производства	про➊из➊вод➊ства
производства	про➊из➊водст➊ва
производство	про➊из➊вод➊ство
производство	про➊из➊водст➊во
произошел	про➊изо➊шел
произошло	про➊изо➊шло
происходит	про➊ис➊хо➊дит
происхождения	про➊ис➊хо➊жде➊ния
происхождения	про➊ис➊хож➊де➊ния
пройдет	прой➊дет
пройдут	прой➊дут
пройти	прой➊ти
просьбой	прось➊бой
прямо	пря➊мо
путем	пу➊тем
пути	пу➊ти
путина	пу➊ти➊на
путину	пу➊ти➊ну
путиным	пу➊ти➊ным
путин	пу➊тин
пунктов	пунк➊тов
пусть	пусть
путь	путь
пытается	пы➊та➊ет➊ся
пытались	пы➊та➊лись
пытаются	пы➊та➊ют➊ся
пяти	пя➊ти
пятницу	пят➊ни➊цу
пять	пять
работа	ра➊бо➊та
работает	ра➊бо➊та➊ет
работают	ра➊бо➊та➊ют
работал	ра➊бо➊тал
работать	ра➊бо➊тать
работе	ра➊бо➊те
работу	ра➊бо➊ту
работы	ра➊бо➊ты
рабочей	ра➊бо➊чей
рабочие	ра➊бо➊чие
рабочих	ра➊бо➊чих
работ	ра➊бот
работников	ра➊бот➊ни➊ков
ради	ра➊ди
радио	ра➊дио
радиостанции	ра➊дио➊стан➊ции
рады	ра➊ды
раза	ра➊за
разумеется	ра➊зу➊ме➊ет➊ся
ракеты	ра➊ке➊ты
ранения	ра➊не➊ния
ранее	ра➊нее
рано	ра➊но
равно	рав➊но
раз	раз
разве	раз➊ве
развитие	раз➊ви➊тие
развитии	раз➊ви➊тии
развитию	раз➊ви➊тию
развития	раз➊ви➊тия
различные	раз➊лич➊ные
различных	раз➊лич➊ных
размере	раз➊ме➊ре
разрешение	раз➊ре➊ше➊ние
разрешения	раз➊ре➊ше➊ния
разные	раз➊ные
разных	раз➊ных
района	рай➊о➊на
районах	рай➊о➊нах
районе	рай➊о➊не
рамках	рам➊ках
раньше	рань➊ше
расследование	рас➊сле➊до➊ва➊ние
расследования	рас➊сле➊до➊ва➊ния
рассчитывать	рас➊счи➊ты➊вать
растет	рас➊тет
расходов	рас➊хо➊дов
расходы	рас➊хо➊ды
рассказал	рас➊ска➊зал
рассказывает	рас➊ска➊зы➊ва➊ет
рассмотрение	рас➊смот➊ре➊ние
расширение	рас➊ши➊ре➊ние
расширения	рас➊ши➊ре➊ния
реализации	реа➊ли➊за➊ции
реакция	ре➊ак➊ция
революции	ре➊во➊лю➊ции
регулярно	ре➊гу➊ляр➊но
редактор	ре➊дак➊тор
редакции	ре➊дак➊ции
режима	ре➊жи➊ма
режим	ре➊жим
резолюции	ре➊зо➊лю➊ции
результатам	ре➊зуль➊та➊там
результате	ре➊зуль➊та➊те
результатов	ре➊зуль➊та➊тов
результаты	ре➊зуль➊та➊ты
результат	ре➊зуль➊тат
респондентов	ре➊спон➊ден➊тов
ресурсов	ре➊сур➊сов
референдума	ре➊фе➊рен➊ду➊ма
референдум	ре➊фе➊рен➊дум
реформы	ре➊фор➊мы
реформ	ре➊форм
речи	ре➊чи
решать	ре➊шать
решением	ре➊ше➊ни➊ем
решение	ре➊ше➊ние
решении	ре➊ше➊нии
решений	ре➊ше➊ний
решению	ре➊ше➊нию
решения	ре➊ше➊ния
решили	ре➊ши➊ли
решил	ре➊шил
решить	ре➊шить
регистрации	ре➊ги➊ст➊ра➊ции
региона	ре➊гио➊на
регионах	ре➊гио➊нах
регионе	ре➊гио➊не
регионов	ре➊гио➊нов
регион	ре➊ги➊он
резко	рез➊ко
рейн	рейн
рейтинг	рей➊тинг
республике	рес➊пуб➊ли➊ке
республики	рес➊пуб➊ли➊ки
речь	речь
риа	риа
риск	риск
рода	ро➊да
родине	ро➊ди➊не
родину	ро➊ди➊ну
родители	ро➊ди➊те➊ли
родителей	ро➊ди➊те➊лей
родился	ро➊дил➊ся
рождения. рождения	ро➊жде➊ния. рож➊де➊ния
роли	ро➊ли
ромашенко	ро➊ма➊шен➊ко
роман	ро➊ман
роста	ро➊ста
родственников	род➊ствен➊ни➊ков
роль	роль
россией	рос➊си➊ей
россияне	рос➊си➊я➊не
россиян	рос➊си➊ян
россии	рос➊сии
российская	рос➊сий➊ская
российскими	рос➊сий➊ски➊ми
российские	рос➊сий➊ские
российский	рос➊сий➊ский
российским	рос➊сий➊ским
российских	рос➊сий➊ских
российско	рос➊сий➊ско
российского	рос➊сий➊ско➊го
российскому	рос➊сий➊ско➊му
российское	рос➊сий➊ское
российской	рос➊сий➊ской
российском	рос➊сий➊ском
российскую	рос➊сий➊скую
россию	рос➊сию
россия	рос➊сия
рост	рост
рубежом	ру➊бе➊жом
рублей	руб➊лей
руках	ру➊ках
руки	ру➊ки
руководители	ру➊ко➊во➊ди➊те➊ли
руководителя	ру➊ко➊во➊ди➊те➊ля
руководителей	ру➊ко➊во➊ди➊те➊лей
руководитель	ру➊ко➊во➊ди➊тель
руководства	ру➊ко➊вод➊ства
руководство	ру➊ко➊вод➊ство
руководством	ру➊ко➊вод➊ством
румынии	ру➊мы➊нии
русские	рус➊ские
русский	рус➊ский
русских	рус➊ских
русского	рус➊ско➊го
русской	рус➊ской
русском	рус➊ском
рынок	ры➊нок
рынка	рын➊ка
рынках	рын➊ках
рынке	рын➊ке
ряда	ря➊да
ряде	ря➊де
рядом	ря➊дом
ряд	ряд
саакашвили	са➊а➊ка➊шви➊ли
сама	са➊ма
самая	са➊мая
сами	са➊ми
самих	са➊мих
самые	са➊мые
самый	са➊мый
самым	са➊мым
самых	са➊мых
савченко	сав➊чен➊ко
саддама	сад➊да➊ма
сайт	сайт
сайте	сай➊те
саксонии	сак➊со➊нии
сам	сам
саммита	сам➊ми➊та
саммите	сам➊ми➊те
саммит	сам➊мит
само	са➊мо
самого	са➊мо➊го
самолета	са➊мо➊ле➊та
самолетов	са➊мо➊ле➊тов
самолет	са➊мо➊лет
самостоятельно	са➊мо➊сто➊я➊тель➊но
самое	са➊мое
самой	са➊мой
самом	са➊мом
санкции	санк➊ции
санкций	санк➊ций
санкт	санкт
саркози	сар➊ко➊зи
сборная	сбор➊ная
сборной	сбор➊ной
свдп	свдп
сведения	све➊де➊ния
свет	свет
свидетельствует	сви➊де➊тель➊ству➊ет
свидетельствуют	сви➊де➊тель➊ству➊ют
свобода	сво➊бо➊да
свободе	сво➊бо➊де
свободу	сво➊бо➊ду
свободы	сво➊бо➊ды
свободного	сво➊бод➊но➊го
свободной	сво➊бод➊ной
своего	сво➊его
своему	сво➊ему
своей	сво➊ей
своем	сво➊ем
свое	свое
своё	своё
своём	сво➊ём
свои	свои
своими	сво➊ими
своим	сво➊им
своих	сво➊их
свой	свой
свою	свою
свыше	свы➊ше
связано	свя➊за➊но
связаны	свя➊за➊ны
связанные	свя➊зан➊ные
связанных	свя➊зан➊ных
связи	свя➊зи
связь	связь
сдпг	сдпг
сделали	сде➊ла➊ли
сделано	сде➊ла➊но
сделал	сде➊лал
сделать	сде➊лать
себе	се➊бе
себя	се➊бя
севере	се➊ве➊ре
северной	се➊вер➊ной
северный	се➊вер➊ный
секретаря	се➊кре➊та➊ря
секретарь	се➊кре➊тарь
семей	се➊мей
семи	се➊ми
семье	се➊мье
семьи	се➊мьи
семья	се➊мья
сепаратистов	се➊па➊ра➊ти➊стов
середине	се➊ре➊ди➊не
серьезно	серь➊ез➊но
серьезные	серь➊ез➊ные
сети	се➊ти
сегодня	се➊го➊дня
сегодняшний	се➊го➊дняш➊ний
сегодняшний	се➊го➊дня➊шний
сейчас	сей➊час
сектора	сек➊то➊ра
секторе	сек➊то➊ре
семь	семь
сентябре	сен➊тя➊бре
сентября	сен➊тя➊бря
сербии	сер➊бии
сергей	сер➊гей
сергея	сер➊гея
сеть	сеть
силами	си➊ла➊ми
силой	си➊лой
силу	си➊лу
силы	си➊лы
сирии	си➊рии
система	си➊сте➊ма
системе	си➊сте➊ме
систему	си➊сте➊му
системы	си➊сте➊мы
ситуацией	си➊ту➊а➊ци➊ей
ситуации	си➊ту➊а➊ции
ситуацию	си➊ту➊а➊цию
ситуация	си➊ту➊а➊ция
сигнал	сиг➊нал
сил	сил
сильно	силь➊но
сих	сих
скажем	ска➊жем
сказала	ска➊за➊ла
сказал	ска➊зал
сказать	ска➊зать
скандал	скан➊дал
скорее	ско➊рее
скоро	ско➊ро
сколько	сколь➊ко
следовало	сле➊до➊ва➊ло
следует	сле➊ду➊ет
следующее	сле➊ду➊ю➊щее
следующем	сле➊ду➊ю➊щем
следующий	сле➊ду➊ю➊щий
следствие	след➊ствие
следствие	следст➊вие
следствия	след➊ствия
следствия	следст➊вия
слишком	слиш➊ком
слова	сло➊ва
словами	сло➊ва➊ми
словам	сло➊вам
слово	сло➊во
слов	слов
сложно	слож➊но
сложности	слож➊но➊сти
случаев	слу➊ча➊ев
случаях	слу➊ча➊ях
случае	слу➊чае
случаи	слу➊чаи
случай	слу➊чай
случайно	слу➊чай➊но
случаю	слу➊чаю
служба	служ➊ба
службе	служ➊бе
службу	служ➊бу
службы	служ➊бы
смерти	смер➊ти
смерть	смерть
сми	сми
смогут	смо➊гут
сможет	смо➊жет
смог	смог
смогли	смог➊ли
смотрите	смо➊три➊те
смысле	смыс➊ле
смысл	смысл
сначала	сна➊ча➊ла
снг	снг
снижение	сни➊же➊ние
снизить	сни➊зить
снова	сно➊ва
собирается	со➊би➊ра➊ет➊ся
собираются	со➊би➊ра➊ют➊ся
собой	со➊бой
событий	со➊бы➊тий
события	со➊бы➊тия
совета	со➊ве➊та
совершенно	со➊вер➊шен➊но
совет	со➊вет
советских	со➊вет➊ских
советского	со➊вет➊ско➊го
советской	со➊вет➊ской
совсем	со➊всем
соглашение	со➊гла➊ше➊ние
соглашения	со➊гла➊ше➊ния
согласно	со➊глас➊но
содержание	со➊дер➊жа➊ние
содержания	со➊дер➊жа➊ния
сожалению	со➊жа➊ле➊нию
создание	со➊зда➊ние
создании	со➊зда➊нии
созданию	со➊зда➊нию
создания	со➊зда➊ния
создать	со➊здать
сократить	со➊кра➊тить
сокращение	со➊кра➊ще➊ние
сомнения	со➊мне➊ния
сообщает	со➊об➊ща➊ет
сообщается	со➊об➊ща➊ет➊ся
сообщают	со➊об➊ща➊ют
сообщение	со➊об➊ще➊ние
сообщении	со➊об➊ще➊нии
сообщению	со➊об➊ще➊нию
сообщения	со➊об➊ще➊ния
сообщества	со➊об➊ще➊ства
сообщество	со➊об➊ще➊ство
сообщила	со➊об➊щи➊ла
сообщили	со➊об➊щи➊ли
сообщило	со➊об➊щи➊ло
сообщил	со➊об➊щил
соответственно	со➊от➊вет➊ствен➊но
соответственно	со➊от➊ветст➊вен➊но
соответствии	со➊от➊вет➊ствии
соответствии	со➊от➊ветст➊вии
соответствует	со➊от➊вет➊ству➊ет
соответствует	со➊от➊ветст➊вует
соответствующее	со➊от➊вет➊ству➊ю➊щее
соответствующее	со➊от➊ветст➊ву➊ю➊щее
соответствующие	со➊от➊вет➊ству➊ю➊щие
соответствующие	со➊от➊ветст➊ву➊ю➊щие
состава	со➊ста➊ва
составе	со➊ста➊ве
составил	со➊ста➊вил
составит	со➊ста➊вит
состав	со➊став
составляет	со➊став➊ля➊ет
составляют	со➊став➊ля➊ют
состоит	со➊сто➊ит
состоится	со➊сто➊ит➊ся
состоялась	со➊стоя➊лась
состояние	со➊стоя➊ние
состоянии	со➊стоя➊нии
сотрудники	со➊труд➊ни➊ки
сотрудников	со➊труд➊ни➊ков
сотрудничества	со➊труд➊ни➊че➊ства
сотрудничества	со➊труд➊ни➊чест➊ва
сотрудничестве	со➊труд➊ни➊че➊стве
сотрудничестве	со➊труд➊ни➊чест➊ве
сотрудничество	со➊труд➊ни➊че➊ство
сотрудничество	со➊труд➊ни➊чест➊во
сотрудничеству	со➊труд➊ни➊че➊ству
сотрудничеству	со➊труд➊ни➊чест➊ву
сотрудник	со➊труд➊ник
социал	со➊ци➊ал
социально	со➊ци➊аль➊но
социального	со➊ци➊аль➊но➊го
социальной	со➊ци➊аль➊ной
социальные	со➊ци➊аль➊ные
социальных	со➊ци➊аль➊ных
сочи	со➊чи
союза	со➊ю➊за
союз	со➊юз
союзников	со➊юз➊ни➊ков
собственно	соб➊ствен➊но
собственного	соб➊ствен➊но➊го
собственной	соб➊ствен➊ной
собственные	соб➊ствен➊ные
собственных	соб➊ствен➊ных
совместно	сов➊мест➊но
современного	со➊вре➊мен➊но➊го
современной	со➊вре➊мен➊ной
солдаты	сол➊да➊ты
солдат	сол➊дат
сотни	сот➊ни
сохранить	со➊хра➊нить
спасибо	спа➊си➊бо
специалистов	спе➊ци➊а➊ли➊стов
специалисты	спе➊ци➊а➊ли➊сты
специально	спе➊ци➊аль➊но
специальный	спе➊ци➊аль➊ный
спектр	спектр
спецслужбы	спец➊служ➊бы
спецслужб	спец➊служб
список	спи➊сок
списке	спи➊ске
спокойно	спо➊кой➊но
споры	спо➊ры
способствовать	спо➊соб➊ство➊вать
способствовать	спо➊собст➊во➊вать
спрос	спрос
спустя	спу➊стя
сразу	сра➊зу
сравнению	срав➊не➊нию
среди	сре➊ди
среды	сре➊ды
среднего	сред➊не➊го
среднем	сред➊нем
средства	сред➊ства
средства	средст➊ва
средств	средств
среду	сре➊ду
срока	сро➊ка
сроки	сро➊ки
срок	срок
ссср	ссср
ссылкой	ссыл➊кой
ста	ста
стабильности	ста➊биль➊но➊сти
стабильности	ста➊биль➊нос➊ти
стала	ста➊ла
стали	ста➊ли
стало	ста➊ло
станет	ста➊нет
становится	ста➊но➊вит➊ся
становятся	ста➊но➊вят➊ся
станут	ста➊нут
статуса	ста➊ту➊са
статус	ста➊тус
статье	ста➊тье
статьи	ста➊тьи
ставку	став➊ку
стал	стал
станции	стан➊ции
стать	стать
стены	сте➊ны
степени	сте➊пе➊ни
степовик	сте➊по➊вик
сто	сто
стоимость	сто➊и➊мость
стоит	сто➊ит
столице	сто➊ли➊це
столицы	сто➊ли➊цы
сторона	сто➊ро➊на
стороне	сто➊ро➊не
сторону	сто➊ро➊ну
стороны	сто➊ро➊ны
сторон	сто➊рон
сторонники	сто➊рон➊ни➊ки
сторонников	сто➊рон➊ни➊ков
стоят	сто➊ят
столкновения	столк➊но➊ве➊ния
столь	столь
столько	столь➊ко
страна	стра➊на
странами	стра➊на➊ми
странам	стра➊нам
странах	стра➊нах
стране	стра➊не
странице	стра➊ни➊це
страной	стра➊ной
страну	стра➊ну
страны	стра➊ны
стратегии	стра➊те➊гии
стран	стран
страх	страх
стремится	стре➊мит➊ся
строительства	строи➊тель➊ства
строительства	строи➊тельст➊ва
строительство	строи➊тель➊ство
строительство	строи➊тельст➊во
структуры	струк➊ту➊ры
структур	струк➊тур
студентов	сту➊ден➊тов
студенты	сту➊ден➊ты
суда	су➊да
суде	су➊де
судом	су➊дом
судьи	су➊дьи
судья	су➊дья
судя	су➊дя
сути	су➊ти
существенно	су➊ще➊ст➊вен➊но
существует	су➊ще➊ст➊ву➊ет
существуют	су➊ще➊ст➊ву➊ют
субботу	суб➊бо➊ту
суд	суд
судьба	судь➊ба
сумма	сум➊ма
сумму	сум➊му
суммы	сум➊мы
сфере	сфе➊ре
счет	счет
считает	счи➊та➊ет
считается	счи➊та➊ет➊ся
считают	счи➊та➊ют
считать	счи➊тать
считаю	счи➊таю
сша	сша
сын	сын
сюда	сю➊да
таджикистана	та➊джи➊ки➊ста➊на
таджикистане	та➊джи➊ки➊ста➊не
таджикистан	та➊джи➊ки➊стан
такая	та➊кая
таки	та➊ки
такими	та➊ки➊ми
такие	та➊кие
таким	та➊ким
таких	та➊ких
такого	та➊ко➊го
такому	та➊ко➊му
такое	та➊кое
такой	та➊кой
таком	та➊ком
такую	та➊кую
талибов	та➊ли➊бов
таймс	таймс
так	так
также	так➊же
там	там
тбилиси	тби➊ли➊си
театра	те➊ат➊ра
текущего	те➊ку➊ще➊го
тема	те➊ма
темой	те➊мой
тему	те➊му
темы	те➊мы
теперь	те➊перь
текст	текст
телеканала	те➊ле➊ка➊на➊ла
тем	тем
темненков	тем➊нен➊ков
теракта	тер➊ак➊та
терактов	тер➊ак➊тов
теракты	тер➊ак➊ты
теракт	тер➊акт
территории	тер➊ри➊то➊рии
территорию	тер➊ри➊то➊рию
террористической	тер➊ро➊ри➊сти➊че➊ской
террористов	тер➊ро➊ри➊стов
террористы	тер➊ро➊ри➊сты
терроризма	тер➊ро➊риз➊ма
терроризмом	тер➊ро➊риз➊мом
тех	тех
техники	тех➊ни➊ки
технологии	тех➊но➊ло➊гии
технологий	тех➊но➊ло➊гий
течение	те➊че➊ние
тимошенко	ти➊мо➊шен➊ко
типа	ти➊па
товаров	то➊ва➊ров
товары	то➊ва➊ры
тогда	то➊гда
того	то➊го
тоже	то➊же
томас	то➊мас
тому	то➊му
той	той
только	толь➊ко
том	том
тонн	тонн
топлива	топ➊ли➊ва
торговли	тор➊гов➊ли
тот	тот
точки	точ➊ки
точку	точ➊ку
точно	точ➊но
трагедии	тра➊ге➊дии
традиции	тра➊ди➊ции
трампа	трам➊па
трамп	трамп
транспорта	транс➊пор➊та
требование	тре➊бо➊ва➊ние
требования	тре➊бо➊ва➊ния
требует	тре➊бу➊ет
требуют	тре➊бу➊ют
трети	тре➊ти
третий	тре➊тий
третьего	треть➊е➊го
треть	треть
трех	трех
три	три
трое	трое
труда	тру➊да
трудно	труд➊но
трудности	труд➊но➊сти
туда	ту➊да
туристов	ту➊ри➊стов
турции	тур➊ции
турция	тур➊ция
туркменистана	турк➊ме➊ни➊ста➊на
туркмении	турк➊ме➊нии
тут	тут
тысячи	ты➊ся➊чи
тысяч	ты➊сяч
тюрьме	тюрь➊ме
тюрьмы	тюрь➊мы
убежища	убе➊жи➊ща
убийства	убий➊ства
убийстве	убий➊стве
убийство	убий➊ство
увеличение	уве➊ли➊че➊ние
увеличить	уве➊ли➊чить
уверены	уве➊ре➊ны
уверен	уве➊рен
увидеть	уви➊деть
уголовного	уго➊лов➊но➊го
уголовное	уго➊лов➊ное
угрожает	угро➊жа➊ет
угроза	угро➊за
угрозой	угро➊зой
угрозу	угро➊зу
угрозы	угро➊зы
удалось	уда➊лось
удар	удар
удастся	удаст➊ся
уже	уже
узбекистана	уз➊бе➊ки➊ста➊на
узбекистане	уз➊бе➊ки➊ста➊не
узбекистан	уз➊бе➊ки➊стан
узнать	узнать
уйти	уй➊ти
указал	ука➊зал
указывает	ука➊зы➊ва➊ет
украина	ук➊ра➊и➊на
украине	ук➊ра➊и➊не
украиной	ук➊ра➊и➊ной
украину	ук➊ра➊и➊ну
украины	ук➊ра➊и➊ны
украинские	ук➊ра➊ин➊ские
украинский	ук➊ра➊ин➊ский
украинских	ук➊ра➊ин➊ских
украинского	ук➊ра➊инс➊ко➊го
украинской	ук➊ра➊ин➊ской
улицах	ули➊цах
улице	ули➊це
улицы	ули➊цы
университета	уни➊вер➊си➊те➊та
университете	уни➊вер➊си➊те➊те
университет	уни➊вер➊си➊тет
управления	управ➊ле➊ния
урегулированию	уре➊гу➊ли➊ро➊ва➊нию
урегулирования	уре➊гу➊ли➊ро➊ва➊ния
уровень	уро➊вень
уровне	уров➊не
уровня	уров➊ня
усилить	уси➊лить
усилия	уси➊лия
условиях	усло➊ви➊ях
условий	усло➊вий
условия	усло➊вия
услуги	услу➊ги
услуг	услуг
успеха	успе➊ха
успех	успех
успешно	успеш➊но
установить	уста➊но➊вить
утверждает	утвер➊жда➊ет
утверждает	утверж➊да➊ет
утверждают	утвер➊жда➊ют
утверждают	утверж➊да➊ют
утра	утра
утром	ут➊ром
участием	уча➊сти➊ем
участие	уча➊стие
участии	уча➊стии
участия	уча➊стия
участвовали	уча➊ст➊во➊ва➊ли
участвовать	уча➊ст➊во➊вать
участвуют	уча➊ст➊ву➊ют
участники	участ➊ни➊ки
участников	участ➊ни➊ков
ученые	уче➊ные
учёные	учё➊ные
ученых	уче➊ных
учитывая	учи➊ты➊вая
ущерб	ущерб
фактически	фак➊ти➊че➊ски
факты	фак➊ты
факт	факт
федерации	фе➊де➊ра➊ции
федерального	фе➊де➊раль➊но➊го
федеральное	фе➊де➊раль➊ное
федеральной	фе➊де➊раль➊ной
федеральный	фе➊де➊раль➊ный
федеральных	фе➊де➊раль➊ных
фестиваля	фе➊сти➊ва➊ля
фестиваль	фе➊сти➊валь
феврале	фев➊ра➊ле
февраля	фев➊ра➊ля
финансирования	фи➊нан➊си➊ро➊ва➊ния
финансового	фи➊нан➊со➊во➊го
финансовой	фи➊нан➊со➊вой
финансовые	фи➊нан➊со➊вые
финансовый	фи➊нан➊со➊вый
финансовых	фи➊нан➊со➊вых
финансов	фи➊нан➊сов
фифа	фи➊фа
фишер	фи➊шер
фильма	филь➊ма
фильм	фильм
фирма	фир➊ма
фирмы	фир➊мы
фирм	фирм
фоне	фо➊не
форума	фо➊ру➊ма
форум	фо➊рум
фон	фон
фонда	фон➊да
фонд	фонд
форме	фор➊ме
фотографии	фо➊то➊гра➊фии
фракции	фрак➊ции
франции	фран➊ции
франция	фран➊ция
французского	фран➊цуз➊ско➊го
франк	франк
франкфурте	франк➊фур➊те
фрг	фрг
фсб	фсб
футболу	фут➊бо➊лу
хамас	ха➊мас
характер	ха➊рак➊тер
ханс	ханс
хватает	хва➊та➊ет
хдс	хдс
ходе	хо➊де
ходорковского	хо➊дор➊ков➊ско➊го
хозяйства	хо➊зяй➊ства
хозяйства	хо➊зяйст➊ва
холодной	хо➊лод➊ной
хорошие	хо➊ро➊шие
хорошо	хо➊ро➊шо
хотели	хо➊те➊ли
хотелось	хо➊те➊лось
хотел	хо➊тел
хотим	хо➊тим
хотя	хо➊тя
хотят	хо➊тят
хочет	хо➊чет
хочется	хо➊чет➊ся
хочу	хо➊чу
ход	ход
хоть	хоть
христианско	хри➊сти➊ан➊ско
хсс	хсс
хуже	ху➊же
хусейна	ху➊сей➊на
цайтунг	цай➊тунг
целей	це➊лей
цели	це➊ли
целом	це➊лом
целый	це➊лый
целью	це➊лью
целях	це➊лях
цена	це➊на
цены	це➊ны
церемонии	це➊ре➊мо➊нии
цель	цель
цен	цен
центра	цен➊тра
центрального	цен➊траль➊но➊го
центральной	цен➊траль➊ной
центре	цен➊тре
центр	центр
церкви	цер➊кви
церковь	цер➊ковь
цитирует	ци➊ти➊ру➊ет
цик	цик
часа	ча➊са
часов	ча➊сов
части	ча➊сти
частично	ча➊стич➊но
часто	ча➊сто
частью	ча➊стью
чаще	ча➊ще
час	час
частных	част➊ных
частности	част➊но➊сти
часть	часть
чего	че➊го
человека	че➊ло➊ве➊ка
человек	че➊ло➊век
чему	че➊му
через	че➊рез
чехии	че➊хии
чем	чем
чемпионата	чем➊пи➊о➊на➊та
честь	честь
четверг	чет➊верг
четыре	че➊ты➊ре
четырех	че➊ты➊рех
чечне	чеч➊не
чечни	чеч➊ни
чиновники	чи➊нов➊ни➊ки
чиновников	чи➊нов➊ни➊ков
читателей	чи➊та➊те➊лей
числа	чис➊ла
числе	чис➊ле
число	чис➊ло
членами	чле➊на➊ми
членов	чле➊нов
членом	чле➊ном
члены	чле➊ны
член	член
чрезвычайно	чрез➊вы➊чай➊но
что	что
чтобы	что➊бы
чувство	чув➊ство
чуть	чуть
шаги	ша➊ги
шагом	ша➊гом
шаталин	ша➊та➊лин
шаг	шаг
шансы	шан➊сы
шанс	шанс
швеции	шве➊ции
швейцарии	швей➊ца➊рии
шести	ше➊сти
шесть	шесть
широко	ши➊ро➊ко
школах	шко➊лах
школе	шко➊ле
школы	шко➊лы
школ	школ
шла	шла
шоу	шоу
шрёдера	шрё➊де➊ра
шрёдер	шрё➊дер
штаты	шта➊ты
штаб	штаб
штайнмайер	штайн➊май➊ер
што	што
экономика	эко➊но➊ми➊ка
экономике	эко➊но➊ми➊ке
экономики	эко➊но➊ми➊ки
экономику	эко➊но➊ми➊ку
экономические	эко➊но➊ми➊че➊ские
экономический	эко➊но➊ми➊че➊ский
экономических	эко➊но➊ми➊че➊ских
экономического	эко➊но➊ми➊че➊ско➊го
экономической	эко➊но➊ми➊че➊ской
экономии	эко➊но➊мии
экс	экс
эксперта	экс➊пер➊та
экспертов	экс➊пер➊тов
эксперты	экс➊пер➊ты
эксперт	экс➊перт
экспорта	экс➊пор➊та
экспорт	экс➊порт
электроэнергии	элек➊тро➊энер➊гии
энергетики	энер➊ге➊ти➊ки
энергии	энер➊гии
эта	эта
эти	эти
этими	эти➊ми
этим	этим
этих	этих
это	это
этого	это➊го
этому	это➊му
этой	этой
этом	этом
этот	этот
эту	эту
эффект	эф➊фект
эфире	эфи➊ре
юге	юге
юго	юго
южной	юж➊ной
юкоса	юко➊са
юлия	юлия
юрий	юрий
юстиции	юсти➊ции
ющенко	ющен➊ко
является	яв➊ля➊ет➊ся
являются	яв➊ля➊ют➊ся
явно	яв➊но
ядерного	ядер➊но➊го
ядерной	ядер➊ной
языка	язы➊ка
языке	язы➊ке
язык	язык
якобы	яко➊бы
январе	ян➊ва➊ре
января	ян➊ва➊ря
януковича	яну➊ко➊ви➊ча
янукович	яну➊ко➊вич
японии	япо➊нии
ясно	яс➊но
