Form	Hyphenation

# SPDX-License-Identifier: Unicode-DFS-2016

Abbas	Ab➊bas
absolut	ab➊so➊lut
acceptera	ac➊cep➊te➊ra
accepteras	ac➊cep➊te➊ras
advokat	ad➊vo➊kat
advokats	ad➊vo➊kats
affär	af➊fär
affären	af➊fä➊ren
affärens	af➊fä➊rens
affärer	af➊fä➊rer
affärs	af➊färs
Afghanistan	Af➊gha➊ni➊stan
Afghanistans	Af➊gha➊ni➊stans
afghanska	af➊ghans➊ka
AFP	AFP
Afrika	Af➊ri➊ka
afrikanska	af➊ri➊kans➊ka
Afrikas	Af➊ri➊kas
agera	a➊ge➊ra
agerande	a➊ge➊ran➊de
agerar	a➊ge➊rar
Agneta	Ag➊ne➊ta
Agnetas	Ag➊ne➊tas
Ahmed	Ah➊med
Ahmeds	Ah➊meds
aktier	ak➊ti➊er
aktiv	ak➊tiv
aktiva	ak➊ti➊va
aktivas	ak➊ti➊vas
aktivister	ak➊ti➊vis➊ter
aktivisters	ak➊ti➊vis➊ters
aktivt	ak➊tivt
aktuella	ak➊tu➊el➊la
aktuellt	ak➊tu➊ellt
aktörer	ak➊tö➊rer
aktörers	ak➊tö➊rers
akut	akut
aldrig	ald➊rig
Aleppo	Alep➊po
Aleppos	Alep➊pos
Alexander	Alex➊an➊der
Ali	Ali
Alice	Alice
Alis	Alis
alkohol	al➊ko➊hol
all	all
alla	al➊la
allas	al➊las
alldeles	all➊de➊les
alliansen	al➊li➊an➊sen
alliansens	al➊li➊an➊sens
allianspartierna	al➊li➊ans➊par➊ti➊er➊na
allianspartiernas	al➊li➊ans➊par➊ti➊er➊nas
allierade	al➊li➊e➊ra➊de
allierades	al➊li➊e➊ra➊des
allmänheten	all➊män➊he➊ten
allmänhetens	all➊män➊he➊tens
allmänna	all➊män➊na
allmännas	all➊män➊nas
allra	all➊ra
alls	alls
allt	allt
alltför	allt➊för
alltid	all➊tid
alltmer	allt➊mer
allts	allts
alltså	allt➊så
allvar	all➊var
allvarlig	all➊var➊lig
allvarliga	all➊var➊li➊ga
allvarligt	all➊var➊ligt
alternativ	al➊ter➊na➊tiv
ambassad	am➊bas➊sad
ambassaden	am➊bas➊sa➊den
ambassadens	am➊bas➊sa➊dens
ambassadör	am➊bas➊sa➊dör
amerikaner	ame➊ri➊ka➊ner
amerikaners	ame➊ri➊ka➊ners
amerikansk	ame➊ri➊kansk
amerikanska	ame➊ri➊kans➊ka
amerikanske	ame➊ri➊kans➊ke
Amnesty	Am➊ne➊sty
Amnestys	Am➊ne➊stys
analys	ana➊lys
analytiker	ana➊ly➊ti➊ker
analytikers	ana➊ly➊ti➊kers
and	and
andel	an➊del
andelen	an➊de➊len
Anders	An➊ders
Andersson	An➊ders➊son
Anderssons	An➊ders➊sons
andra	and➊ra
andras	and➊ras
Andreas	Andre➊as
Angela	Ange➊la
angrepp	an➊grepp
anhängare	an➊hänga➊re
anhängares	an➊hänga➊res
anhöriga	an➊hö➊ri➊ga
anhörigas	an➊hö➊ri➊gas
anklagade	an➊kla➊ga➊de
anklagades	an➊kla➊ga➊des
anklagar	an➊kla➊gar
anklagas	an➊kla➊gas
anklagelser	an➊kla➊gel➊ser
anklagelserna	an➊kla➊gel➊ser➊na
anledning	an➊led➊ning
Anledningen	An➊led➊ning➊en
anmälan	an➊mä➊lan
anmälningar	an➊mäl➊ning➊ar
Ann	Ann
Anna	Anna
annan	an➊nan
annans	an➊nans
annars	an➊nars
Annas	Annas
annat	an➊nat
annats	an➊nats
Annie	An➊nie
Annika	An➊ni➊ka
Annikas	An➊ni➊kas
annorlunda	an➊nor➊lun➊da
anser	an➊ser
anses	an➊ses
anställa	an➊stäl➊la
anställas	an➊stäl➊las
anställd	an➊ställd
anställda	an➊ställ➊da
anställdas	an➊ställ➊das
anställds	an➊ställds
ansvar	an➊svar
ansvaret	an➊sva➊ret
ansvarig	an➊sva➊rig
ansvariga	an➊sva➊ri➊ga
ansvarigas	an➊sva➊ri➊gas
ansåg	an➊såg
ansågs	an➊sågs
ansökan	an➊sö➊kan
antal	an➊tal
antalet	an➊ta➊let
antingen	an➊ting➊en
använda	an➊vän➊da
användas	an➊vän➊das
använde	an➊vän➊de
använder	an➊vän➊der
användes	an➊vän➊des
används	an➊vänds
använt	an➊vänt
använts	an➊vänts
arabiska	ara➊bis➊ka
arbeta	ar➊be➊ta
arbetade	ar➊be➊ta➊de
arbetades	ar➊be➊ta➊des
arbetar	ar➊be➊tar
arbetare	ar➊be➊ta➊re
arbetares	ar➊be➊ta➊res
arbetas	ar➊be➊tas
arbetat	ar➊be➊tat
arbetats	ar➊be➊tats
arbete	ar➊be➊te
arbetet	ar➊be➊tet
arbetets	ar➊be➊tets
Arbetsförmedlingen	Ar➋bets➊för➋med➋ling➋en
Arbetsförmedlingens	Ar➋bets➊för➋med➋ling➋ens
arbetsgivare	ar➋bets➊gi➋va➋re
arbetsgivaren	ar➋bets➊gi➋va➋ren
arbetsgivarens	ar➋bets➊gi➋va➋rens
arbetsgivares	ar➋bets➊gi➋va➋res
arbetsgivarna	ar➋bets➊gi➋var➋na
arbetsgivarnas	ar➋bets➊gi➋var➋nas
arbetskraft	ar➋bets➊kraft
arbetslösa	ar➋bets➊lö➋sa
arbetslösas	ar➋bets➊lö➋sas
arbetslöshet	ar➋bets➊lös➋het
arbetslösheten	ar➋bets➊lös➋he➋ten
arbetslöshetens	ar➋bets➊lös➋he➋tens
arbetslöshets	ar➋bets➊lös➋hets
arbetsmarknaden	ar➋bets➊mark➋na➋den
arbetsmarknadens	ar➋bets➊mark➋na➋dens
Arlanda	Ar➊lan➊da
Arlandas	Ar➊lan➊das
armén	ar➊mén
arméns	ar➊méns
artikel	ar➊ti➊kel
Asien	Asi➊en
Asiens	Asi➊ens
Ask	Ask
Asks	Asks
Assad	As➊sad
Assads	As➊sads
Assange	As➊sange
Assanges	As➊sanges
asyl	asyl
asylsökande	asyl➊sö➋kan➋de
asylsökandes	asyl➊sö➋kan➋des
att	att
attack	at➊tack
attacken	at➊tack➊en
attackens	at➊tack➊ens
attacker	at➊tack➊er
attackerna	at➊tack➊er➊na
attacks	at➊tacks
attentat	at➊ten➊tat
attentatet	at➊ten➊ta➊tet
August	Au➊gust
augusti	au➊gus➊ti
Augusts	Au➊gusts
Australien	Au➊stra➊li➊en
Australiens	Au➊stra➊li➊ens
avgifter	av➊gif➊ter
avgå	av➊gå
avgång	av➊gång
avgår	av➊går
avgöra	av➊gö➊ra
avgörande	av➊gö➊ran➊de
avgöras	av➊gö➊ras
avled	av➊led
avlidit	av➊li➊dit
avstånd	av➊stånd
avtal	av➊tal
avtalet	av➊ta➊let
avtalets	av➊ta➊lets
avtals	av➊tals
bad	bad
Bagdad	Bag➊dad
Bagdads	Bag➊dads
bakgrund	bak➊grund
bakom	bak➊om
Ban	Ban
Bangkok	Bang➊kok
Bangkoks	Bang➊koks
Bangladesh	Bang➊la➊desh
Bangladeshs	Bang➊la➊deshs
bank	bank
banken	ban➊ken
bankens	ban➊kens
banker	ban➊ker
bankerna	ban➊ker➊na
bankernas	ban➊ker➊nas
bankers	ban➊kers
banks	banks
Bans	Bans
bara	ba➊ra
Barack	Ba➊rack
barn	barn
barnen	bar➊nen
barnens	bar➊nens
barnet	bar➊net
barnets	bar➊nets
barns	barns
Bashar	Bash➊ar
Batra	Bat➊ra
Batras	Bat➊ras
BBC	BBC
BBCs	BBCs
Beatrice	Bea➊trice
bedöma	be➊dö➊ma
bedömare	be➊dö➊ma➊re
bedömares	be➊dö➊ma➊res
bedömas	be➊dö➊mas
bedömer	be➊dö➊mer
bedömning	be➊döm➊ning
bedömningen	be➊döm➊ning➊en
bedöms	be➊döms
befann	be➊fann
befanns	be➊fanns
befarar	be➊fa➊rar
befinner	be➊fin➊ner
befolkning	be➊folk➊ning
befolkningen	be➊folk➊ning➊en
befolkningens	be➊folk➊ning➊ens
befolknings	be➊folk➊nings
begränsa	be➊grän➊sa
begränsas	be➊grän➊sas
begått	be➊gått
begåtts	be➊gåtts
begära	be➊gä➊ra
begäran	be➊gä➊ran
begäras	be➊gä➊ras
begärt	be➊gärt
begärts	be➊gärts
behandlas	be➊hand➊las
behandling	be➊hand➊ling
behandlings	be➊hand➊lings
behov	be➊hov
behovet	be➊ho➊vet
behålla	be➊hål➊la
behållas	be➊hål➊las
behöva	be➊hö➊va
behövas	be➊hö➊vas
behöver	be➊hö➊ver
behövs	be➊hövs
bekräftar	be➊kräf➊tar
bekämpa	be➊käm➊pa
bekämpas	be➊käm➊pas
Belgien	Bel➊gi➊en
Belgiens	Bel➊gi➊ens
Bengt	Bengt
ber	ber
beredd	be➊redd
beredda	be➊red➊da
beredskap	be➊red➊skap
beredskaps	be➊red➊skaps
Berlin	Ber➊lin
Berlins	Ber➊lins
Berlusconi	Ber➊lu➊sco➊ni
Berlusconis	Ber➊lu➊sco➊nis
beroende	be➊ro➊en➊de
beror	be➊ror
beräknas	be➊räk➊nas
berätta	be➊rät➊ta
berättade	be➊rät➊ta➊de
berättades	be➊rät➊ta➊des
berättar	be➊rät➊tar
berättas	be➊rät➊tas
berättat	be➊rät➊tat
berättats	be➊rät➊tats
besked	be➊sked
beskedet	be➊ske➊det
beskriver	be➊skri➊ver
beskrivs	be➊skrivs
beslut	be➊slut
beslutade	be➊slu➊ta➊de
beslutades	be➊slu➊ta➊des
beslutat	be➊slu➊tat
beslutats	be➊slu➊tats
beslutet	be➊slu➊tet
beslutets	be➊slu➊tets
besparingar	be➊spa➊ring➊ar
består	be➊står
bestämma	be➊stäm➊ma
bestämmas	be➊stäm➊mas
bestämt	be➊stämt
bestämts	be➊stämts
besök	be➊sök
besöks	be➊söks
besökte	be➊sök➊te
besöktes	be➊sök➊tes
betala	be➊ta➊la
betalar	be➊ta➊lar
betalas	be➊ta➊las
betalat	be➊ta➊lat
betalats	be➊ta➊lats
betalt	be➊talt
betalts	be➊talts
betonar	be➊to➊nar
bett	bett
betyda	be➊ty➊da
betydelse	be➊ty➊del➊se
betyder	be➊ty➊der
betydligt	be➊tyd➊ligt
betyg	be➊tyg
bevis	be➊vis
beväpnade	be➊väp➊na➊de
bidra	bi➊dra
bidrag	bi➊drag
bidragit	bi➊dra➊git
bidrags	bi➊drags
bidrar	bi➊drar
bil	bil
bilar	bi➊lar
bilars	bi➊lars
bild	bild
bilda	bil➊da
bildas	bil➊das
bilden	bil➊den
bilder	bil➊der
bilderna	bil➊der➊na
bildernas	bil➊der➊nas
Bildt	Bildt
Bildts	Bildts
bilen	bi➊len
bilens	bi➊lens
billigare	bil➊li➊ga➊re
bils	bils
bin	bin
Birath	Bi➊rath
Birgitta	Bir➊git➊ta
Birgittas	Bir➊git➊tas
bistånd	bi➊stånd
bistånds	bi➊stånds
bit	bit
biträdande	bi➊trä➊dan➊de
bits	bits
Björklund	Björk➊lund
Björklunds	Björk➊lunds
Björn	Björn
Björns	Björns
Blair	Blair
Blairs	Blairs
bland	bland
Blekinge	Ble➊kinge
Blekinges	Ble➊kinges
blev	blev
bli	bli
blir	blir
blivit	bli➊vit
BNP	BNP
boende	bo➊en➊de
boendes	bo➊en➊des
bolag	bo➊lag
bolagen	bo➊la➊gen
bolagens	bo➊la➊gens
bolaget	bo➊la➊get
bolagets	bo➊la➊gets
bolags	bo➊lags
bor	bor
borde	bor➊de
Borg	Borg
borgerliga	bor➊ger➊li➊ga
borgerligas	bor➊ger➊li➊gas
Borgs	Borgs
bort	bort
borta	bor➊ta
bostad	bo➊stad
bostads	bo➊stads
bostäder	bo➊stä➊der
bostäders	bo➊stä➊ders
botten	bot➊ten
bra	bra
brand	brand
branden	bran➊den
brandens	bran➊dens
brands	brands
branschen	bran➊schen
branschens	bran➊schens
Brasilien	Bra➊si➊li➊en
Brasiliens	Bra➊si➊li➊ens
bred	bred
Breivik	Brei➊vik
Breiviks	Brei➊viks
brev	brev
brist	brist
bristande	bris➊tan➊de
bristen	bris➊ten
brister	bris➊ter
brittisk	brit➊tisk
brittiska	brit➊tis➊ka
brott	brott
brotten	brot➊ten
brottens	brot➊tens
brottet	brot➊tet
brottets	brot➊tets
brotts	brotts
brottslighet	brotts➊lig➊het
brukar	bru➊kar
brutit	bru➊tit
brutits	bru➊tits
Bryssel	Brys➊sel
Bryssels	Brys➊sels
bryta	bry➊ta
brytas	bry➊tas
bryter	bry➊ter
bråk	bråk
brödraskapet	bröd➊ra➊ska➊pet
brödraskapets	bröd➊ra➊ska➊pets
bröt	bröt
bröts	bröts
bud	bud
budget	bud➊get
budgeten	bud➊ge➊ten
budgetens	bud➊ge➊tens
buds	buds
budskap	bud➊skap
Burma	Bur➊ma
Burmas	Bur➊mas
Bush	Bush
Bushs	Bushs
buss	buss
bussar	bus➊sar
butiker	bu➊ti➊ker
butikers	bu➊ti➊kers
byar	by➊ar
bygga	byg➊ga
byggas	byg➊gas
bygger	byg➊ger
byggnaden	bygg➊na➊den
byggnadens	bygg➊na➊dens
byggnader	bygg➊na➊der
byggnaders	bygg➊na➊ders
byn	byn
byns	byns
byta	by➊ta
bytas	by➊tas
båda	bå➊da
bådas	bå➊das
både	bå➊de
båtar	bå➊tar
bär	bär
bära	bä➊ra
bäras	bä➊ras
bärs	bärs
bäst	bäst
bästa	bäs➊ta
bättre	bätt➊re
bör	bör
börja	bör➊ja
började	bör➊ja➊de
börjades	bör➊ja➊des
början	bör➊jan
börjar	bör➊jar
börjas	bör➊jas
börjat	bör➊jat
börs	börs
börsen	bör➊sen
börsens	bör➊sens
böter	bö➊ter
Cameron	Ca➊me➊ron
Camerons	Ca➊me➊rons
cancer	can➊cer
Carl	Carl
Carls	Carls
Carlsson	Carls➊son
Carlssons	Carls➊sons
Cecilia	Ce➊ci➊lia
Cecilias	Ce➊ci➊lias
Centerpartiet	Cen➋ter➊par➋ti➋et
Centerpartiets	Cen➋ter➊par➋ti➋ets
centrala	cen➊tra➊la
centralbanken	cen➋tral➊ban➋ken
centralbankens	cen➋tral➊ban➋kens
centrum	cent➊rum
chans	chans
chansen	chan➊sen
chef	chef
chefen	che➊fen
chefens	che➊fens
chefer	che➊fer
chefers	che➊fers
chefs	chefs
Christer	Chris➊ter
Christian	Chris➊ti➊an
Christians	Chris➊ti➊ans
CIA	CIA
CIAs	CIAs
cirka	cir➊ka
civila	ci➊vi➊la
civilas	ci➊vi➊las
Claes	Claes
Clinton	Clin➊ton
Clintons	Clin➊tons
CNN	CNN
Colombia	Co➋lom➊bia
Colombias	Co➋lom➊bias
Cypern	Cy➊pern
Cyperns	Cy➊perns
dag	dag
dagar	da➊gar
dagarna	da➊gar➊na
dagarnas	da➊gar➊nas
dagars	da➊gars
Dagbladet	Dag➊bla➋det
Dagbladets	Dag➊bla➋dets
dagen	da➊gen
dagens	da➊gens
dags	dags
dagsläget	dags➊lä➊get
Dalarna	Da➊lar➊na
Dalarnas	Da➊lar➊nas
Damaskus	Da➊mas➊kus
Dan	Dan
Daniel	Da➊ni➊el
Daniels	Da➊ni➊els
Danmark	Dan➊mark
Danmarks	Dan➊marks
dansk	dansk
danska	dans➊ka
Darfur	Dar➊fur
Darfurs	Dar➊furs
datorer	da➊to➊rer
datorers	da➊to➊rers
David	Da➊vid
Davids	Da➊vids
debatt	de➊batt
debatten	de➊bat➊ten
debattens	de➊bat➊tens
december	de➊cem➊ber
definitivt	de➊fi➊ni➊tivt
del	del
dela	de➊la
delar	de➊lar
delarna	de➊lar➊na
delas	de➊las
delen	de➊len
dels	dels
delstaten	del➊sta➊ten
delstatens	del➊sta➊tens
delta	del➊ta
deltagit	del➊ta➊git
deltar	del➊tar
deltog	del➊tog
delvis	del➊vis
dem	dem
demokraterna	de➊mo➊kra➊ter➊na
demokraternas	de➊mo➊kra➊ter➊nas
demokrati	de➊mo➊kra➊ti
demokratis	de➊mo➊kra➊tis
demokratiska	de➊mo➊kra➊tis➊ka
demonstranter	de➊mon➊stran➊ter
demonstranterna	de➊mon➊stran➊ter➊na
demonstranternas	de➊mon➊stran➊ter➊nas
demonstranters	de➊mon➊stran➊ters
demonstration	de➊mon➊stra➊tion
demonstrationer	de➊mon➊stra➊tio➊ner
demonstrationerna	de➊mon➊stra➊tio➊ner➊na
demonstrationernas	de➊mon➊stra➊tio➊ner➊nas
demonstrations	de➊mon➊stra➊tions
den	den
denna	den➊na
dens	dens
deras	de➊ras
dess	dess
dessa	des➊sa
Dessutom	Dess➊utom
desto	des➊to
det	det
detaljer	de➊tal➊jer
detta	det➊ta
dialog	dia➊log
dig	dig
din	din
direkt	di➊rekt
diskriminering	dis➊kri➊mi➊ne➊ring
diskriminerings	dis➊kri➊mi➊ne➊rings
diskussion	dis➊kus➊sion
diskussionen	dis➊kus➊sio➊nen
diskussioner	dis➊kus➊sio➊ner
diskutera	dis➊ku➊te➊ra
diskuterar	dis➊ku➊te➊rar
diskuteras	dis➊ku➊te➊ras
display	dis➊play
dit	dit
djupt	djupt
djur	djur
djurs	djurs
DNA	DNA
dock	dock
dog	dog
dokument	do➊ku➊ment
dollar	dol➊lar
dollars	dol➊lars
dom	dom
domare	do➊ma➊re
domaren	do➊ma➊ren
domarens	do➊ma➊rens
domares	do➊ma➊res
domen	do➊men
domens	do➊mens
doms	doms
domstol	dom➊stol
domstolen	dom➊sto➊len
domstolens	dom➊sto➊lens
domstols	dom➊stols
Donald	Do➊nald
Donalds	Do➊nalds
dotter	dot➊ter
dotters	dot➊ters
dra	dra
drabbade	drab➊ba➊de
drabbades	drab➊ba➊des
drabbar	drab➊bar
drabbas	drab➊bas
drabbat	drab➊bat
drabbats	drab➊bats
dragit	dra➊git
dragits	dra➊gits
drar	drar
dras	dras
driva	dri➊va
drivas	dri➊vas
driver	dri➊ver
drivit	dri➊vit
drivits	dri➊vits
drog	drog
drogs	drogs
drygt	drygt
dubbelt	dub➊belt
dygn	dygn
dygnet	dyg➊net
dygnets	dyg➊nets
dygns	dygns
dyrare	dy➊ra➊re
dyrt	dyrt
dådet	då➊det
dålig	då➊lig
dåliga	då➊li➊ga
dåligt	då➊ligt
dåvarande	då➊va➊ran➊de
där	där
därefter	där➊ef➊ter
däremot	där➊emot
därför	där➊för
däribland	där➊i➊bland
därifrån	där➊i➊från
därmed	där➊med
död	död
döda	dö➊da
dödade	dö➊da➊de
dödades	dö➊da➊des
dödas	dö➊das
dödat	dö➊dat
dödats	dö➊dats
döds	döds
dödsfall	döds➊fall
dödsoffer	döds➊of➋fer
dömas	dö➊mas
dömdes	döm➊des
döms	döms
dömts	dömts
dör	dör
dött	dött
effekt	ef➊fekt
effekter	ef➊fek➊ter
effektivt	ef➊fek➊tivt
efter	ef➊ter
efterfrågan	ef➋ter➊frå➋gan
eftermiddag	ef➋ter➊mid➋dag
eftermiddagen	ef➋ter➊mid➋da➋gen
eftermiddagens	ef➋ter➊mid➋da➋gens
eftermiddags	ef➋ter➊mid➋dags
eftersom	ef➋ter➊som
efteråt	ef➋ter➊åt
egen	egen
egentligen	egent➊li➊gen
eget	eget
egna	egna
Egypten	Egyp➊ten
Egyptens	Egyp➊tens
egyptiska	egyp➊tis➊ka
ekonomi	eko➊no➊mi
ekonomin	eko➊no➊min
ekonomins	eko➊no➊mins
ekonomis	eko➊no➊mis
ekonomisk	eko➊no➊misk
ekonomiska	eko➊no➊mis➊ka
ekonomiskt	eko➊no➊miskt
Ekot	Ekot
Ekots	Ekots
eld	eld
elever	ele➊ver
eleverna	ele➊ver➊na
elevernas	ele➊ver➊nas
elevers	ele➊vers
Eliasson	Eli➊as➊son
Eliassons	Eli➊as➊sons
Elisabeth	Eli➊sa➊beth
Elisabeths	Eli➊sa➊beths
eller	el➊ler
elva	el➊va
emot	emot
ena	ena
enas	enas
enbart	en➊bart
enda	en➊da
endast	en➊dast
energi	ener➊gi
energis	ener➊gis
engelska	eng➊els➊ka
England	Eng➊land
Englands	Eng➊lands
enkelt	en➊kelt
enklare	enk➊la➊re
enligt	en➊ligt
enorma	enor➊ma
ens	ens
ensam	en➊sam
ensamkommande	en➋sam➊kom➋man➋de
ensamkommandes	en➋sam➊kom➋man➋des
enskilda	en➊skil➊da
enskildas	en➊skil➊das
erbjuda	er➊bju➊da
erbjudas	er➊bju➊das
erbjuder	er➊bju➊der
Erdogan	Er➊do➊gan
Erdogans	Er➊do➊gans
erfarenhet	er➊fa➊ren➊het
Eric	Eric
Ericsson	Erics➊son
Ericssons	Erics➊sons
Erik	Erik
Eriks	Eriks
Eriksson	Eriks➊son
Erikssons	Eriks➊sons
erkänna	er➊kän➊na
erkännas	er➊kän➊nas
erkänt	er➊känt
erkänts	er➊känts
ersätta	er➊sät➊ta
ersättas	er➊sät➊tas
ersättning	er➊sätt➊ning
Etiopien	Eti➊o➊pi➊en
Etiopiens	Eti➊o➊pi➊ens
ett	ett
euro	eu➊ro
euron	eu➊ron
eurons	eu➊rons
Europa	Eu➊ro➊pa
Europas	Eu➊ro➊pas
europeiska	eu➊ro➊pe➊is➊ka
euros	eu➊ros
Eva	Eva
Evas	Evas
eventuell	even➊tu➊ell
eventuella	even➊tu➊el➊la
eventuellt	even➊tu➊ellt
exakt	ex➊akt
exempel	ex➊em➊pel
exempelvis	ex➊em➊pel➊vis
experter	ex➊per➊ter
experters	ex➊per➊ters
exploderade	ex➊plo➊de➊ra➊de
explosionen	ex➊plo➊sio➊nen
explosionens	ex➊plo➊sio➊nens
export	ex➊port
exports	ex➊ports
extra	ex➊tra
extremt	ex➊tremt
Facebook	Face➊book
Facebooks	Face➊books
facket	fack➊et
fackets	fack➊ets
fackförbundet	fack➊för➋bun➋det
fackförbundets	fack➊för➋bun➋dets
fakta	fak➊ta
faktiskt	fak➊tiskt
faktum	fak➊tum
fall	fall
fallen	fal➊len
faller	fal➊ler
fallet	fal➊let
fallets	fal➊lets
fallit	fal➊lit
falls	falls
falska	fals➊ka
familj	fa➊milj
familjen	fa➊mil➊jen
familjens	fa➊mil➊jens
familjer	fa➊mil➊jer
familjers	fa➊mil➊jers
familjs	fa➊miljs
fanns	fanns
fara	fa➊ra
farliga	far➊li➊ga
farligt	far➊ligt
fart	fart
fartyg	far➊tyg
fartyget	far➊ty➊get
fartygets	far➊ty➊gets
fartygs	far➊tygs
fast	fast
fatta	fat➊ta
fattas	fat➊tas
fattiga	fat➊ti➊ga
fattigas	fat➊ti➊gas
februari	feb➊ru➊a➊ri
February	Feb➊ru➊a➊ry
fel	fel
fem	fem
femte	fem➊te
fick	fick
Filippinerna	Fi➊lip➊pi➊ner➊na
Filippinernas	Fi➊lip➊pi➊ner➊nas
film	film
filmen	fil➊men
filmens	fil➊mens
finansiella	fi➊nan➊si➊el➊la
Finansinspektionen	Fi➋nans➊in➋spek➋tio➋nen
Finansinspektionens	Fi➋nans➊in➋spek➋tio➋nens
finanskrisen	fi➋nans➊kri➋sen
finanskrisens	fi➋nans➊kri➋sens
finansminister	fi➋nans➊mi➋nis➋ter
finansministern	fi➋nans➊mi➋nis➋tern
finansministerns	fi➋nans➊mi➋nis➋terns
Finland	Fin➊land
Finlands	Fin➊lands
finnas	fin➊nas
finns	finns
finska	fins➊ka
fjol	fjol
fjärde	fjär➊de
fler	fler
flera	fle➊ra
flest	flest
flesta	fles➊ta
flestas	fles➊tas
flicka	flicka
flickan	flick➊an
flickans	flick➊ans
flickas	flickas
flickor	flick➊or
flickors	flick➊ors
fly	fly
flydde	flyd➊de
flyg	flyg
flyga	fly➊ga
flygas	fly➊gas
flygbolaget	flyg➊bo➋la➋get
flygbolagets	flyg➊bo➋la➋gets
flygplan	flyg➊plan
flygplans	flyg➊plans
flygplats	flyg➊plats
flygplatsen	flyg➊plat➋sen
flygplatsens	flyg➊plat➋sens
flygs	flygs
flykt	flykt
flyktingar	flyk➊ting➊ar
flyktingarna	flyk➊ting➊ar➊na
flyktingarnas	flyk➊ting➊ar➊nas
flyktingars	flyk➊ting➊ars
flytt	flytt
flytta	flyt➊ta
flyttar	flyt➊tar
flyttas	flyt➊tas
FN:S	FN:S
fokus	fo➊kus
folk	folk
folket	fol➊ket
folkets	fol➊kets
folkomröstning	folk➋om➊röst➋ning
folkomröstningen	folk➋om➊röst➋ning➋en
folkomröstningens	folk➋om➊röst➋ning➋ens
Folkpartiet	Folk➊par➋ti➋et
Folkpartiets	Folk➊par➋ti➋ets
folks	folks
for	for
fordon	for➊don
fordons	for➊dons
form	form
formellt	for➊mellt
former	for➊mer
fors	fors
forskare	fors➊ka➊re
forskares	fors➊ka➊res
forskarna	fors➊kar➊na
forskarnas	fors➊kar➊nas
forskning	forsk➊ning
forsknings	forsk➊nings
fort	fort
fortfarande	fort➊fa➋ran➋de
forts	forts
fortsatt	fort➊satt
fortsatta	fort➊sat➋ta
fortsatte	fort➊sat➋te
fortsätta	fort➊sät➋ta
fortsättas	fort➊sät➋tas
fortsätter	fort➊sät➋ter
fram	fram
framför	fram➊för
framförallt	fram➊för➊allt
framförs	fram➊förs
framgång	fram➊gång
framgår	fram➊går
framtid	fram➊tid
framtida	fram➊ti➊da
framtiden	fram➊ti➊den
framtidens	fram➊ti➊dens
framåt	fram➊åt
framöver	fram➊över
Frankrike	Frank➊ri➋ke
Frankrikes	Frank➊ri➋kes
fransk	fransk
franska	frans➊ka
fred	fred
fredag	fre➊dag
fredagen	fre➊da➊gen
fredagens	fre➊da➊gens
fredags	fre➊dags
Fredrik	Fred➊rik
Fredriks	Fred➊riks
Fredriksson	Fred➊riks➊son
freds	freds
fri	fri
fria	fria
frias	frias
Fridolin	Fri➊do➊lin
Fridolins	Fri➊do➊lins
frihet	fri➊het
fritt	fritt
fru	fru
frus	frus
fråga	frå➊ga
frågan	frå➊gan
frågans	frå➊gans
frågar	frå➊gar
frågas	frå➊gas
frågor	frå➊gor
frågorna	frå➊gor➊na
från	från
främst	främst
främsta	främs➊ta
full	full
fullt	fullt
function	func➊tion
fundera	fun➊de➊ra
fungera	fun➊ge➊ra
fungerar	fun➊ge➊rar
funnits	fun➊nits
fyra	fy➊ra
fyras	fy➊ras
fångar	fång➊ar
fångars	fång➊ars
får	får
fått	fått
fängelse	fäng➊el➊se
fängelsestraff	fäng➊el➊se➊straff
fängelset	fäng➊el➊set
fängelsets	fäng➊el➊sets
fängslade	fängs➊la➊de
fängslades	fängs➊la➊des
färre	fär➊re
Följ	Följ
följa	föl➊ja
följas	föl➊jas
följd	följd
följde	följ➊de
följdes	följ➊des
följer	föl➊jer
följt	följt
följts	följts
föll	föll
för	för
föra	fö➊ra
föras	fö➊ras
förbereder	för➊be➊re➊der
förbi	för➊bi
förbjudet	för➊bju➊det
förbud	för➊bud
förbudet	för➊bu➊det
förbundskansler	för➋bunds➊kans➋ler
förbättra	för➊bätt➊ra
förbättras	för➊bätt➊ras
fördes	för➊des
före	fö➊re
förekommer	fö➋re➊kom➋mer
förekommit	fö➋re➊kom➋mit
föremål	fö➋re➊mål
föreslår	fö➋re➊slår
föreslås	fö➋re➊slås
företag	fö➋re➊tag
företagare	fö➋re➊ta➋ga➋re
företagen	fö➋re➊ta➋gen
företagens	fö➋re➊ta➋gens
företaget	fö➋re➊ta➋get
företagets	fö➋re➊ta➋gets
företags	fö➋re➊tags
företrädare	fö➋re➊trä➋da➋re
företrädares	fö➋re➊trä➋da➋res
förhandla	för➊hand➊la
förhandlas	för➊hand➊las
förhandlingar	för➊hand➊ling➊ar
förhandlingarna	för➊hand➊ling➊ar➊na
förhandlingarnas	för➊hand➊ling➊ar➊nas
förhindra	för➊hind➊ra
förhindras	för➊hind➊ras
förhållande	för➊hål➊lan➊de
förhållanden	för➊hål➊lan➊den
förhör	för➊hör
förhörs	för➊hörs
förklara	för➊kla➊ra
förklarade	för➊kla➊ra➊de
förklarades	för➊kla➊ra➊des
förklarar	för➊kla➊rar
förklaras	för➊kla➊ras
förklaring	för➊kla➊ring
förklaringen	för➊kla➊ring➊en
förlora	för➊lo➊ra
förlorade	för➊lo➊ra➊de
förlorades	för➊lo➊ra➊des
förlorar	för➊lo➊rar
förloras	för➊lo➊ras
förlorat	för➊lo➊rat
förlorats	för➊lo➊rats
förlust	för➊lust
förmiddagen	för➊mid➊da➊gen
förmiddagens	för➊mid➊da➊gens
förmodligen	för➊mod➊li➊gen
förmåga	för➊må➊ga
förnekar	för➊ne➊kar
förr	förr
förra	för➊ra
förre	för➊re
förrän	förr➊än
förs	förs
förslag	för➊slag
förslagen	för➊sla➊gen
förslaget	för➊sla➊get
förslagets	för➊sla➊gets
först	först
första	förs➊ta
förstå	för➊stå
förstår	för➊står
förstås	för➊stås
förståss	för➊ståss
försvann	för➊svann
försvar	för➊svar
försvara	för➊sva➊ra
försvaras	för➊sva➊ras
försvaret	för➊sva➊ret
försvarets	för➊sva➊rets
försvars	för➊svars
Försvarsmakten	För➊svars➊mak➋ten
Försvarsmaktens	För➊svars➊mak➋tens
försvarsminister	för➋svars➊mi➋nis➋ter
försvinner	för➊svin➊ner
försvunnit	för➊svun➊nit
Försäkringskassan	För➋säk➋rings➊kas➋san
Försäkringskassans	För➋säk➋rings➊kas➋sans
försäljning	för➊sälj➊ning
försäljningen	för➊sälj➊ning➊en
försäljningens	för➊sälj➊ning➊ens
försäljnings	för➊sälj➊nings
försök	för➊sök
försöka	för➊sö➊ka
försöker	för➊sö➊ker
försökt	för➊sökt
försökte	för➊sök➊te
förtroende	för➊tro➊en➊de
förtroendet	för➊tro➊en➊det
förts	förts
förundersökning	för➊un➋der➊sök➋ning
förundersökningen	för➊un➋der➊sök➋ning➋en
förundersökningens	för➊un➋der➊sök➋ning➋ens
förut	för➊ut
Förutom	För➊utom
förutsättningar	för➊ut➊sätt➊ning➊ar
förvånad	för➊vå➊nad
föräldrar	för➊äld➊rar
föräldrarna	för➊äld➊rar➊na
föräldrarnas	för➊äld➊rar➊nas
föräldrars	för➊äld➊rars
förändra	för➊änd➊ra
förändras	för➊änd➊ras
förändring	för➊änd➊ring
förändringar	för➊änd➊ring➊ar
gamla	gam➊la
gamlas	gam➊las
gammal	gam➊mal
ganska	gans➊ka
garantera	ga➊ran➊te➊ra
garanteras	ga➊ran➊te➊ras
gas	gas
gass	gass
gatan	ga➊tan
gatans	ga➊tans
gator	ga➊tor
gatorna	ga➊tor➊na
gav	gav
gavs	gavs
Gaza	Ga➊za
Gazas	Ga➊zas
gemensam	ge➊men➊sam
gemensamma	ge➊men➊sam➊ma
gemensamt	ge➊men➊samt
generaldirektör	ge➋ne➋ral➊di➋rek➋tör
generalsekreterare	ge➋ne➋ral➊sek➋re➋te➋ra➋re
generalsekreterares	ge➋ne➋ral➊sek➋re➋te➋ra➋res
generellt	ge➊ne➊rellt
genom	ge➊nom
genomföra	ge➊nom➊fö➊ra
genomföras	ge➊nom➊fö➊ras
genomfördes	ge➊nom➊för➊des
genomfört	ge➊nom➊fört
genomförts	ge➊nom➊förts
genomsnitt	ge➊nom➊snitt
gentemot	gent➊emot
George	Ge➊or➊ge
Georges	Ge➊or➊ges
ger	ger
gerillan	ge➊ril➊lan
gerillans	ge➊ril➊lans
ges	ges
gett	gett
getts	getts
gick	gick
gicks	gicks
gillar	gil➊lar
gisslan	giss➊lan
gisslans	giss➊lans
gjorde	gjor➊de
gjordes	gjor➊des
gjort	gjort
gjorts	gjorts
glad	glad
glass	glass
global	glo➊bal
globala	glo➊ba➊la
god	god
goda	go➊da
godas	go➊das
godkänt	god➊känt
godkänts	god➊känts
gods	gods
Gotland	Got➊land
Gotlands	Got➊lands
gott	gott
grad	grad
grader	gra➊der
graders	gra➊ders
grads	grads
grannlandet	grann➊lan➋det
grannlandets	grann➊lan➋dets
granska	grans➊ka
granskas	grans➊kas
granskat	grans➊kat
granskats	grans➊kats
granskning	gransk➊ning
gransknings	gransk➊nings
gratis	gra➊tis
grekiska	gre➊kis➊ka
Grekland	Grek➊land
Greklands	Grek➊lands
greps	greps
gripit	gri➊pit
gripits	gri➊pits
gripna	grip➊na
gripnas	grip➊nas
grov	grov
grova	gro➊va
grovt	grovt
grund	grund
grunden	grun➊den
grundläggande	grund➊läg➋gan➋de
grupp	grupp
gruppen	grup➊pen
gruppens	grup➊pens
grupper	grup➊per
grupperna	grup➊per➊na
gruppernas	grup➊per➊nas
gruppers	grup➊pers
grupps	grupps
gräns	gräns
gränsen	grän➊sen
gränsens	grän➊sens
gränser	grän➊ser
gränsers	grän➊sers
gröna	grö➊na
grönas	grö➊nas
Gunilla	Gu➊nil➊la
Gunnar	Gun➊nar
Gunnars	Gun➊nars
Gustafsson	Gustafs➊son
Gustafssons	Gustafs➊sons
Gustav	Gustav
Gustavs	Gustavs
Gustavsson	Gustavs➊son
Gustavssons	Gustavs➊sons
gång	gång
gången	gång➊en
gångens	gång➊ens
gånger	gång➊er
gångs	gångs
går	går
gårdagens	går➊da➊gens
gått	gått
gåtts	gåtts
gälla	gäl➊la
gällande	gäl➊lan➊de
gällde	gäll➊de
gäller	gäl➊ler
gärna	gär➊na
gärningsmannen	gär➋nings➊man➋nen
gärningsmannens	gär➋nings➊man➋nens
gör	gör
göra	gö➊ra
Göran	Gö➊ran
Görans	Gö➊rans
göras	gö➊ras
görs	görs
Götaland	Gö➋ta➊land
Götalands	Gö➋ta➊lands
Göteborg	Gö➋te➊borg
Göteborgs	Gö➋te➊borgs
Haag	Haag
Haags	Haags
hade	ha➊de
haft	haft
Haiti	Hai➊ti
Haitis	Hai➊tis
Halland	Hal➊land
Hallands	Hal➊lands
halv	halv
halvt	halvt
halvår	halv➊år
halvåret	halv➊året
halvårets	halv➊årets
halvårs	halv➊års
Hamas	Ha➊mas
hamna	ham➊na
hamnade	ham➊na➊de
hamnar	ham➊nar
hamnat	ham➊nat
han	han
hand	hand
handel	han➊del
handeln	han➊deln
handelns	han➊delns
handels	han➊dels
handla	hand➊la
handlade	hand➊la➊de
handlades	hand➊la➊des
handlar	hand➊lar
handlas	hand➊las
handlat	hand➊lat
handlats	hand➊lats
handlingar	hand➊ling➊ar
hands	hands
Hanna	Han➊na
hans	hans
hantera	han➊te➊ra
hanteras	han➊te➊ras
har	har
havet	ha➊vet
havets	ha➊vets
Hej	Hej
hel	hel
hela	he➊la
helas	he➊las
Helena	He➊le➊na
helgen	hel➊gen
helgens	hel➊gens
helikoptrar	he➋li➊kopt➊rar
heller	hel➊ler
helst	helst
helt	helt
hem	hem
hemliga	hem➊li➊ga
hemma	hem➊ma
hems	hems
hemsida	hem➊si➊da
henne	hen➊ne
hennes	hen➊nes
Henrik	Henrik
Henriks	Henriks
heter	he➊ter
Hillary	Hil➊la➊ry
Hillarys	Hil➊la➊rys
hindra	hind➊ra
hindras	hind➊ras
historia	his➊to➊ria
historias	his➊to➊rias
historien	his➊to➊ri➊en
historiens	his➊to➊ri➊ens
historiskt	his➊to➊riskt
hit	hit
hits	hits
hitta	hit➊ta
hittade	hit➊ta➊de
hittades	hit➊ta➊des
hittar	hit➊tar
hittas	hit➊tas
hittat	hit➊tat
hittats	hit➊tats
hittills	hit➊tills
hiv	hiv
hjälp	hjälp
hjälpa	hjäl➊pa
hjälpas	hjäl➊pas
hjälper	hjäl➊per
hjälps	hjälps
hjälpt	hjälpt
hjälpts	hjälpts
Hollande	Hol➊lan➊de
Hollandes	Hol➊lan➊des
Holm	Holm
Holms	Holms
homosexuella	ho➋mo➊sex➋u➋el➋la
homosexuellas	ho➋mo➊sex➋u➋el➋las
hon	hon
honom	ho➊nom
hopp	hopp
hoppas	hop➊pas
Horner	Hor➊ner
Horners	Hor➊ners
hos	hos
hot	hot
hotade	ho➊ta➊de
hotades	ho➊ta➊des
hotar	ho➊tar
hotas	ho➊tas
hotat	ho➊tat
hotats	ho➊tats
hotell	ho➊tell
hotet	ho➊tet
hovrätten	hov➊rät➊ten
hovrättens	hov➊rät➊tens
http	http
https	https
Human	Hu➊man
Humans	Hu➊mans
hundra	hun➊dra
hundratals	hun➋dra➊tals
hundratusentals	hun➋dra➊tu➋sen➊tals
hur	hur
huruvida	hu➊ru➊vi➊da
hus	hus
huset	hu➊set
husets	hu➊sets
hushåll	hus➊håll
hushållen	hus➊hål➊len
hushållens	hus➊hål➊lens
hushålls	hus➊hålls
huvud	hu➊vud
huvudet	hu➊vu➊det
huvudets	hu➊vu➊dets
huvudstad	hu➋vud➊stad
huvudstaden	hu➋vud➊sta➋den
huvudstadens	hu➋vud➊sta➋dens
Håkan	Hå➊kan
håll	håll
hålla	hål➊la
hållas	hål➊las
håller	hål➊ler
hållet	hål➊let
hållit	hål➊lit
hållits	hål➊lits
hålls	hålls
hård	hård
hårda	hår➊da
hårdare	hår➊da➊re
hårdas	hår➊das
hårt	hårt
häktad	häk➊tad
hälften	hälf➊ten
hälsa	häl➊sa
hälsas	häl➊sas
hända	hän➊da
hände	hän➊de
händelsen	hän➊del➊sen
händelser	hän➊del➊ser
händelserna	hän➊del➊ser➊na
händelsernas	hän➊del➊ser➊nas
händer	hän➊der
hänger	häng➊er
hänsyn	hän➊syn
hänt	hänt
hänvisar	hän➊vi➊sar
här	här
häromdagen	här➊om➊da➊gen
hävdade	häv➊da➊de
hävdades	häv➊da➊des
hävdar	häv➊dar
hög	hög
höga	hö➊ga
högre	hög➊re
högs	högs
högst	högst
högsta	högs➊ta
högt	högt
höja	hö➊ja
höjas	hö➊jas
höjd	höjd
höjda	höj➊da
höjs	höjs
höll	höll
hölls	hölls
hör	hör
höra	hö➊ra
höras	hö➊ras
hörde	hör➊de
hördes	hör➊des
hörs	hörs
hört	hört
hörts	hörts
höst	höst
höstas	hös➊tas
hösten	hös➊ten
höstens	hös➊tens
icke	icke
idag	idag
ifrån	ifrån
igen	igen
igenom	ige➊nom
igång	igång
igår	igår
ihjäl	ihjäl
ihop	ihop
illa	il➊la
illegala	il➊le➊ga➊la
IMF	IMF
IMFs	IMFs
inblandade	in➊blan➊da➊de
inblandades	in➊blan➊da➊des
inblandning	in➊bland➊ning
Indien	In➊di➊en
Indiens	In➊di➊ens
indiska	in➊dis➊ka
Indonesien	In➋do➊ne➊si➋en
Indonesiens	In➋do➊ne➊si➋ens
industri	in➊dust➊ri
industrin	in➊dust➊rin
industrins	in➊dust➊rins
industris	in➊dust➊ris
inflationen	in➊fla➊tio➊nen
inflytande	in➊fly➊tan➊de
information	in➊for➊ma➊tion
informationen	in➊for➊ma➊tio➊nen
informations	in➊for➊ma➊tions
infrastruktur	in➋fra➊struk➋tur
inför	in➊för
införa	in➊fö➊ra
införas	in➊fö➊ras
infördes	in➊för➊des
införs	in➊förs
infört	in➊fört
införts	in➊förts
inga	inga
ingen	ing➊en
ingens	ing➊ens
ingenting	ing➊en➊ting
Inger	Ing➊er
inget	ing➊et
Ingrid	In➊grid
ingå	in➊gå
ingår	in➊går
ingås	in➊gås
initiativ	ini➊ti➊a➊tiv
initiativs	ini➊ti➊a➊tivs
inklusive	in➊klu➊si➊ve
inkomster	in➊koms➊ter
inleda	in➊le➊da
inledas	in➊le➊das
inledde	in➊led➊de
inleddes	in➊led➊des
inleds	in➊leds
inlett	in➊lett
inletts	in➊letts
innan	in➊nan
inne	in➊ne
innebär	in➊ne➊bär
innebära	in➊ne➊bä➊ra
innehåller	in➊ne➊hål➊ler
inom	in➊om
inre	in➊re
inrikesminister	in➋ri➋kes➊mi➋nis➋ter
insats	in➊sats
insatsen	in➊sat➊sen
insatsens	in➊sat➊sens
insatser	in➊sat➊ser
institutet	in➊sti➊tu➊tet
institutets	in➊sti➊tu➊tets
inställning	in➊ställ➊ning
inte	in➊te
integritet	in➊teg➊ri➊tet
interna	in➊ter➊na
International	In➋ter➊na➋tio➋nal
Internationals	In➋ter➊na➋tio➋nals
internationell	in➋ter➊na➋tio➋nell
internationella	in➋ter➊na➋tio➋nel➋la
internationellt	in➋ter➊na➋tio➋nellt
internet	in➋ter➊net
internets	in➋ter➊nets
intervju	in➋ter➊vju
intill	in➊till
intressant	in➊tres➊sant
intresse	in➊tres➊se
intressen	in➊tres➊sen
intressens	in➊tres➊sens
intresserade	in➊tres➊se➊ra➊de
intresset	in➊tres➊set
inträffade	in➊träf➊fa➊de
inträffat	in➊träf➊fat
invandrare	in➊vand➊ra➊re
invandrares	in➊vand➊ra➊res
investera	in➊ve➊ste➊ra
investerare	in➊ve➊ste➊ra➊re
investerares	in➊ve➊ste➊ra➊res
investeras	in➊ve➊ste➊ras
investeringar	in➊ve➊ste➊ring➊ar
invånare	in➊vå➊na➊re
invånares	in➊vå➊na➊res
invånarna	in➊vå➊nar➊na
invånarnas	in➊vå➊nar➊nas
Irak	Irak
irakier	ira➊ki➊er
irakiers	ira➊ki➊ers
irakiska	ira➊kis➊ka
Iraks	Iraks
Iran	Iran
Irans	Irans
iranska	irans➊ka
Irland	Ir➊land
Irlands	Ir➊lands
ISIS	ISIS
islam	is➊lam
Islamiska	Is➊la➊mis➊ka
islamistiska	is➊la➊mis➊tis➊ka
islams	is➊lams
Island	Is➊land
Islands	Is➊lands
Israel	Is➊ra➊el
israelisk	is➊ra➊e➊lisk
israeliska	is➊ra➊e➊lis➊ka
Israels	Is➊ra➊els
Istanbul	Istan➊bul
Istanbuls	Istan➊buls
istället	istäl➊let
Italien	Ita➊li➊en
Italiens	Ita➊li➊ens
italienska	ita➊li➊ens➊ka
iväg	iväg
jag	jag
jakten	jak➊ten
jaktens	jak➊tens
Jan	Jan
Jans	Jans
januari	ja➊nu➊a➊ri
januaris	ja➊nu➊a➊ris
January	Ja➊nu➊a➊ry
Japan	Ja➊pan
Japans	Ja➊pans
japanska	ja➊pans➊ka
Jean	Jean
Jemen	Je➊men
Jemens	Je➊mens
Jenny	Jen➊ny
Jennys	Jen➊nys
Jens	Jens
Jerusalem	Je➊ru➊sa➊lem
Jerusalems	Je➊ru➊sa➊lems
Jimmie	Jim➊mie
Jimmies	Jim➊mies
jobb	jobb
jobba	job➊ba
jobbar	job➊bar
jobbas	job➊bas
jobbat	job➊bat
jobbats	job➊bats
jobben	job➊ben
jobbens	job➊bens
jobbet	job➊bet
jobbets	job➊bets
Johan	Jo➊han
Johans	Jo➊hans
Johansson	Jo➊hans➊son
Johanssons	Jo➊hans➊sons
John	John
Johns	Johns
Jonas	Jo➊nas
Jonsson	Jons➊son
Jonssons	Jons➊sons
jordbävningen	jord➊bäv➋ning➋en
jordbävningens	jord➊bäv➋ning➋ens
jorden	jor➊den
jordens	jor➊dens
journalist	jour➊na➊list
journalisten	jour➊na➊lis➊ten
journalistens	jour➊na➊lis➊tens
journalister	jour➊na➊lis➊ter
journalisters	jour➊na➊lis➊ters
journalists	jour➊na➊lists
jul	jul
juli	ju➊li
Julia	Ju➊lia
Julias	Ju➊lias
July	Ju➊ly
June	Ju➊ne
Junes	Ju➊nes
juni	ju➊ni
just	just
justitieminister	ju➋sti➋tie➊mi➋nis➋ter
jämfört	jäm➊fört
jämförts	jäm➊förts
Jämtland	Jämt➊land
Jämtlands	Jämt➊lands
Jönköping	Jön➊kö➋ping
Jönköpings	Jön➊kö➋pings
Jönsson	Jöns➊son
Jönssons	Jöns➊sons
Kabul	Ka➊bul
Kabuls	Ka➊buls
Kadaffi	Ka➋daf➊fi
Kadaffis	Ka➋daf➊fis
Kairo	Kai➊ro
Kairos	Kai➊ros
kalla	kal➊la
kallad	kal➊lad
kallade	kal➊la➊de
kallades	kal➊la➊des
kallar	kal➊lar
kallas	kal➊las
kallat	kal➊lat
kallats	kal➊lats
Kalmar	Kal➊mar
Kalmars	Kal➊mars
kamp	kamp
kampanj	kam➊panj
kampen	kam➊pen
kan	kan
Kanada	Ka➊na➊da
Kanadas	Ka➊na➊das
kanalen	ka➊na➊len
kanalens	ka➊na➊lens
kandidat	kan➊di➊dat
kandidater	kan➊di➊da➊ter
kandidaters	kan➊di➊da➊ters
kandidats	kan➊di➊dats
kans	kans
kanske	kanske
kaos	ka➊os
Karin	Ka➊rin
Karins	Ka➊rins
Karl	Karl
Karlsson	Karls➊son
Karlssons	Karls➊sons
Karolinska	Ka➊ro➊lins➊ka
Karolinskas	Ka➊ro➊lins➊kas
kassan	kas➊san
kassans	kas➊sans
Katarina	Ka➊ta➊ri➊na
katastrof	ka➊ta➊strof
katastrofen	ka➊ta➊stro➊fen
katastrofens	ka➊ta➊stro➊fens
Kenya	Ken➊ya
Kenyas	Ken➊yas
Kerry	Ker➊ry
Kerrys	Ker➊rys
Kerstin	Ker➊stin
Kiev	Kiev
Kievs	Kievs
kilo	ki➊lo
kilometer	ki➋lo➊me➋ter
kilometers	ki➋lo➊me➋ters
kilos	ki➊los
Kim	Kim
Kims	Kims
Kina	Ki➊na
Kinas	Ki➊nas
Kinberg	Kin➊berg
Kinbergs	Kin➊bergs
kinesiska	ki➊ne➊sis➊ka
Kjell	Kjell
klar	klar
klara	kla➊ra
klarar	kla➊rar
klaras	kla➊ras
klart	klart
klass	klass
klockan	klock➊an
kläder	klä➊der
knappast	knap➊past
knappt	knappt
kollegor	kol➊le➊gor
kollegors	kol➊le➊gors
kom	kom
komma	kom➊ma
kommande	kom➊man➊de
kommas	kom➊mas
kommentar	kom➊men➊tar
kommentarer	kom➊men➊ta➊rer
kommentera	kom➊men➊te➊ra
kommenterar	kom➊men➊te➊rar
kommenteras	kom➊men➊te➊ras
kommer	kom➊mer
kommers	kom➊mers
kommissionen	kom➊mis➊sio➊nen
kommissionens	kom➊mis➊sio➊nens
kommit	kom➊mit
kommits	kom➊mits
kommun	kom➊mun
kommunala	kom➊mu➊na➊la
kommunen	kom➊mu➊nen
kommunens	kom➊mu➊nens
kommuner	kom➊mu➊ner
kommunerna	kom➊mu➊ner➊na
kommunernas	kom➊mu➊ner➊nas
kommuners	kom➊mu➊ners
kommuns	kom➊muns
kompetens	kom➊pe➊tens
konflikt	kon➊flikt
konflikten	kon➊flik➊ten
konfliktens	kon➊flik➊tens
konflikter	kon➊flik➊ter
Kongo	Kon➊go
Kongos	Kon➊gos
kongress	kon➊gress
kongressen	kon➊gres➊sen
kongressens	kon➊gres➊sens
konkret	kon➊kret
konkreta	kon➊kre➊ta
konkurrens	kon➊kur➊rens
konkurrensen	kon➊kur➊ren➊sen
konkurrensens	kon➊kur➊ren➊sens
konkurs	kon➊kurs
konsekvenser	kon➊se➊kven➊ser
konsekvenserna	kon➊se➊kven➊ser➊na
konservativa	kon➊ser➊va➊ti➊va
konservativas	kon➊ser➊va➊ti➊vas
konstatera	kon➊sta➊te➊ra
konstaterar	kon➊sta➊te➊rar
konstateras	kon➊sta➊te➊ras
konstigt	kons➊tigt
konsumenterna	kon➊su➊men➊ter➊na
konsumenternas	kon➊su➊men➊ter➊nas
kontakt	kon➊takt
kontakter	kon➊tak➊ter
kontor	kon➊tor
kontors	kon➊tors
kontroll	kon➊troll
kontrollen	kon➊trol➊len
kontroller	kon➊trol➊ler
kontrollera	kon➊trol➊le➊ra
kontrollerar	kon➊trol➊le➊rar
kontrolleras	kon➊trol➊le➊ras
kontroversiella	kon➊tro➊ver➊si➊el➊la
koppling	kopp➊ling
kopplingar	kopp➊ling➊ar
korrespondent	kor➊re➊spon➊dent
korrespondents	kor➊re➊spon➊dents
korruption	kor➊rup➊tion
korruptions	kor➊rup➊tions
kort	kort
korta	kor➊ta
kortare	kor➊ta➊re
kortas	kor➊tas
Kosovo	Ko➊so➊vo
Kosovos	Ko➊so➊vos
kosta	kos➊ta
kostar	kos➊tar
kostnaden	kost➊na➊den
kostnader	kost➊na➊der
kostnaderna	kost➊na➊der➊na
kraft	kraft
kraftig	kraf➊tig
kraftiga	kraf➊ti➊ga
kraftigt	kraf➊tigt
krafts	krafts
krav	krav
kraven	kra➊ven
kravet	kra➊vet
kravs	kravs
krig	krig
kriget	kri➊get
krigets	kri➊gets
krigs	krigs
Krim	Krim
kriminella	kri➊mi➊nel➊la
kriminellas	kri➊mi➊nel➊las
Krims	Krims
kring	kring
krings	krings
kris	kris
krisen	kri➊sen
krisens	kri➊sens
Kristdemokraterna	Krist➊de➋mo➋kra➋ter➋na
Kristdemokraternas	Krist➊de➋mo➋kra➋ter➋nas
kristna	krist➊na
kristnas	krist➊nas
kritik	kri➊tik
kritiken	kri➊ti➊ken
kritiker	kri➊ti➊ker
kritikers	kri➊ti➊kers
kritiserade	kri➊ti➊se➊ra➊de
kritiserades	kri➊ti➊se➊ra➊des
kritiserar	kri➊ti➊se➊rar
kritiserat	kri➊ti➊se➊rat
kritiserats	kri➊ti➊se➊rats
kritisk	kri➊tisk
kritiska	kri➊tis➊ka
kronan	kro➊nan
kronans	kro➊nans
kronor	kro➊nor
kronors	kro➊nors
kroppar	krop➊par
kroppen	krop➊pen
kroppens	krop➊pens
kräva	krä➊va
krävas	krä➊vas
krävde	kräv➊de
krävdes	kräv➊des
kräver	krä➊ver
krävs	krävs
krävt	krävt
krävts	krävts
Kuba	Ku➊ba
Kubas	Ku➊bas
Kulle	Kul➊le
kunde	kun➊de
kunder	kun➊der
kunderna	kun➊der➊na
kundernas	kun➊der➊nas
kunders	kun➊ders
kungen	kung➊en
kungens	kung➊ens
kunna	kun➊na
kunnas	kun➊nas
kunnat	kun➊nat
kunskap	kun➊skap
kunskaps	kun➊skaps
kurdiska	kur➊dis➊ka
kvar	kvar
kvartal	kvar➊tal
kvartalet	kvar➊ta➊let
kvartalets	kvar➊ta➊lets
kvartals	kvar➊tals
kvinna	kvin➊na
kvinnan	kvin➊nan
kvinnans	kvin➊nans
kvinnas	kvin➊nas
kvinnliga	kvinn➊li➊ga
kvinnor	kvin➊nor
kvinnorna	kvin➊nor➊na
kvinnornas	kvin➊nor➊nas
kvinnors	kvin➊nors
kväll	kväll
kvällen	kväl➊len
kvällens	kväl➊lens
kvälls	kvälls
kyrkan	kyr➊kan
kyrkans	kyr➊kans
källa	käl➊la
källor	käl➊lor
källors	käl➊lors
känd	känd
kända	kän➊da
kände	kän➊de
kändes	kän➊des
känna	kän➊na
kännas	kän➊nas
känner	kän➊ner
känns	känns
känsliga	käns➊li➊ga
känt	känt
känts	känts
kärnkraften	kärn➊kraf➋ten
kärnkraftens	kärn➊kraf➋tens
kärnvapen	kärn➊va➋pen
köpa	kö➊pa
köpas	kö➊pas
Köpenhamn	Kö➊pen➋hamn
Köpenhamns	Kö➊pen➋hamns
köper	kö➊per
köpt	köpt
köpts	köpts
kör	kör
köra	kö➊ra
köras	kö➊ras
körde	kör➊de
kördes	kör➊des
körs	körs
kött	kött
kötts	kötts
lade	la➊de
lades	la➊des
lag	lag
lagar	la➊gar
lagars	la➊gars
lagen	la➊gen
lagens	la➊gens
lags	lags
lagstiftning	lag➊stift➋ning
lagstiftningen	lag➊stift➋ning➋en
lagstiftningens	lag➊stift➋ning➋ens
lagt	lagt
lagts	lagts
land	land
landet	lan➊det
landets	lan➊dets
lands	lands
landsting	lands➊ting
landstings	lands➊tings
larm	larm
Lars	Lars
Larsson	Lars➊son
Larssons	Lars➊sons
lastbilar	last➊bi➋lar
leda	le➊da
ledamöter	le➊da➊mö➊ter
ledamöters	le➊da➊mö➊ters
ledande	le➊dan➊de
ledare	le➊da➊re
ledaren	le➊da➊ren
ledarens	le➊da➊rens
ledares	le➊da➊res
ledarna	le➊dar➊na
ledarnas	le➊dar➊nas
ledas	le➊das
ledde	led➊de
leddes	led➊des
leder	le➊der
ledning	led➊ning
ledningen	led➊ning➊en
ledningens	led➊ning➊ens
lednings	led➊nings
legat	le➊gat
Leif	Leif
Lena	Le➊na
Lenas	Le➊nas
Lennart	Len➊nart
lett	lett
letts	letts
leva	le➊va
levas	le➊vas
lever	le➊ver
Libanon	Li➊ba➊non
Libanons	Li➊ba➊nons
Libyen	Li➊by➊en
Libyens	Li➊by➊ens
libyska	li➊bys➊ka
lider	li➊der
ligga	lig➊ga
ligger	lig➊ger
lika	li➊ka
liknande	lik➊nan➊de
liksom	lik➊som
lilla	lil➊la
Lindberg	Lind➊berg
Lindbergs	Lind➊bergs
Lindström	Lind➊ström
Lindströms	Lind➊ströms
linje	lin➊je
Linköping	Lin➊kö➋ping
Linköpings	Lin➊kö➋pings
lista	lis➊ta
listan	lis➊tan
listans	lis➊tans
listas	lis➊tas
lite	li➊te
liten	li➊ten
litet	li➊tet
liv	liv
livet	li➊vet
livets	li➊vets
livs	livs
livsmedel	livs➊me➋del
livsmedels	livs➊me➋dels
ljus	ljus
locka	locka
lockas	lockas
lokal	lo➊kal
lokala	lo➊ka➊la
London	Lon➊don
Londons	Lon➊dons
Lotta	Lot➊ta
lovade	lo➊va➊de
lovades	lo➊va➊des
lovar	lo➊var
lovat	lo➊vat
lovats	lo➊vats
luften	luf➊ten
lugn	lugn
lugnt	lugnt
Luleå	Lu➊leå
Luleås	Lu➊leås
Lund	Lund
Lunds	Lunds
lyckades	lyck➊a➊des
lyckas	lyck➊as
lyckats	lyck➊ats
lyfta	lyf➊ta
lyftas	lyf➊tas
lyssna	lyss➊na
lyssnas	lyss➊nas
låg	låg
låga	lå➊ga
lågt	lågt
lån	lån
låna	lå➊na
lånas	lå➊nas
lång	lång
långa	långa
långsiktigt	lång➊sik➊tigt
långt	långt
låta	lå➊ta
låter	lå➊ter
låtit	lå➊tit
läge	lä➊ge
lägenhet	lä➊gen➊het
lägenheter	lä➊gen➊he➊ter
lägenhets	lä➊gen➊hets
läget	lä➊get
lägets	lä➊gets
lägga	läg➊ga
läggas	läg➊gas
lägger	läg➊ger
läggs	läggs
lägre	läg➊re
lägsta	lägs➊ta
läkare	lä➊ka➊re
läkaren	lä➊ka➊ren
läkarens	lä➊ka➊rens
läkares	lä➊ka➊res
läkemedel	lä➊ke➊me➊del
läkemedels	lä➊ke➊me➊dels
lämna	läm➊na
lämnade	läm➊na➊de
lämnades	läm➊na➊des
lämnar	läm➊nar
lämnas	läm➊nas
lämnat	läm➊nat
lämnats	läm➊nats
län	län
länder	län➊der
länderna	län➊der➊na
ländernas	län➊der➊nas
länders	län➊ders
länge	länge
längre	läng➊re
längs	längs
läns	läns
länsstyrelsen	läns➊sty➋rel➋sen
länsstyrelsens	läns➊sty➋rel➋sens
lär	lär
lära	lä➊ra
lärare	lä➊ra➊re
lärares	lä➊ra➊res
läras	lä➊ras
lärs	lärs
Läs	Läs
läsa	lä➊sa
läsas	lä➊sas
lät	lät
lätt	lätt
lättare	lät➊ta➊re
Löfgren	Löf➊gren
Löfgrens	Löf➊grens
löften	löf➊ten
Löfven	Löf➊ven
Löfvens	Löf➊vens
lön	lön
löner	lö➊ner
lönerna	lö➊ner➊na
lönernas	lö➊ner➊nas
löper	lö➊per
lördag	lör➊dag
lördagen	lör➊da➊gen
lördagens	lör➊da➊gens
lördags	lör➊dags
lösa	lö➊sa
lösas	lö➊sas
lösning	lös➊ning
lösningar	lös➊ning➊ar
Lööf	Lööf
Lööfs	Lööfs
Magdalena	Mag➊da➊le➊na
Magnus	Mag➊nus
Magnusson	Mag➊nus➊son
Magnussons	Mag➊nus➊sons
maj	maj
majoritet	ma➊jo➊ri➊tet
majoriteten	ma➊jo➊ri➊te➊ten
majoritetens	ma➊jo➊ri➊te➊tens
majoritets	ma➊jo➊ri➊tets
majs	majs
Makar	Ma➊kar
makt	makt
makten	mak➊ten
maktens	mak➊tens
makts	makts
Mali	Ma➊li
Malis	Ma➊lis
Malmö	Mal➊mö
Malmös	Mal➊mös
mamma	mam➊ma
mammas	mam➊mas
man	man
mandat	man➊dat
mandats	man➊dats
mannen	man➊nen
mannens	man➊nens
mans	mans
Manuel	Ma➊nu➊el
March	March
Marcus	Mar➊cus
Margareta	Mar➊ga➊re➊ta
Margot	Mar➊got
Maria	Maria
Marias	Marias
Marie	Marie
Maries	Maries
mark	mark
marken	mar➊ken
markens	mar➊kens
marknad	mark➊nad
marknaden	mark➊na➊den
marknadens	mark➊na➊dens
marknads	mark➊nads
mars	mars
Martin	Martin
Martins	Martins
mat	mat
material	ma➊te➊ri➊al
materials	ma➊te➊ri➊als
mats	mats
Mats	Mats
Mattias	Mat➊ti➊as
Maud	Maud
May	May
Mays	Mays
med	med
medan	me➊dan
medans	me➊dans
medarbetare	med➊ar➊be➊ta➊re
medarbetares	med➊ar➊be➊ta➊res
medborgare	med➊bor➊ga➊re
medborgares	med➊bor➊ga➊res
meddelade	med➊de➊la➊de
meddelades	med➊de➊la➊des
meddelar	med➊de➊lar
meddelat	med➊de➊lat
meddelats	med➊de➊lats
medel	me➊del
Medelhavet	Me➊del➊ha➊vet
Medelhavets	Me➊del➊ha➊vets
medger	med➊ger
media	me➊dia
medias	me➊dias
medicin	me➊di➊cin
mediciner	me➊di➊ci➊ner
mediciners	me➊di➊ci➊ners
medier	me➊di➊er
medierna	me➊di➊er➊na
mediernas	me➊di➊er➊nas
mediers	me➊di➊ers
medlem	med➊lem
medlemmar	med➊lem➊mar
medlemmarna	med➊lem➊mar➊na
medlemmarnas	med➊lem➊mar➊nas
medlemmars	med➊lem➊mars
medlems	med➊lems
medlemskap	med➊lem➊skap
medlemskaps	med➊lem➊skaps
medlemsländer	med➋lems➊län➋der
medlemsländers	med➋lems➊län➋ders
meds	meds
mellan	mel➊lan
Mellanöstern	Mel➋lan➊ös➋tern
Mellanösterns	Mel➋lan➊ös➋terns
men	men
menade	me➊na➊de
menar	me➊nar
mens	mens
mer	mer
mera	me➊ra
Merkel	Mer➊kel
Merkels	Mer➊kels
mers	mers
mest	mest
mesta	mes➊ta
meter	me➊ter
meters	me➊ters
metoder	me➊to➊der
Mexiko	Mex➊i➊ko
Mexikos	Mex➊i➊kos
Michael	Mi➊chael
Michaels	Mi➊chaels
mig	mig
migranter	mi➊gran➊ter
migranters	mi➊gran➊ters
Migrationsverket	Mi➋gra➋tions➊ver➋ket
Migrationsverkets	Mi➋gra➋tions➊ver➋kets
Mikael	Mi➋ka➊el
Mikaels	Mi➋ka➊els
mil	mil
Milder	Mil➊der
militanta	mi➊li➊tan➊ta
militär	mi➊li➊tär
militära	mi➊li➊tä➊ra
militären	mi➊li➊tä➊ren
militärens	mi➊li➊tä➊rens
militärer	mi➊li➊tä➊rer
militärers	mi➊li➊tä➊rers
militärs	mi➊li➊tärs
militärt	mi➊li➊tärt
miljard	mil➊jard
miljarder	mil➊jar➊der
miljarders	mil➊jar➊ders
miljon	mil➊jon
miljoner	mil➊jo➊ner
miljoners	mil➊jo➊ners
miljö	mil➊jö
miljön	mil➊jön
miljöns	mil➊jöns
Miljöpartiet	Mil➋jö➊par➋ti➋et
Miljöpartiets	Mil➋jö➊par➋ti➋ets
mils	mils
min	min
mina	mi➊na
mindre	mind➊re
minister	mi➊nis➊ter
ministers	mi➊nis➊ters
ministrar	mi➊nist➊rar
ministrars	mi➊nist➊rars
mins	mins
minska	mins➊ka
minskade	mins➊ka➊de
minskades	mins➊ka➊des
minskar	mins➊kar
minskas	mins➊kas
minskat	mins➊kat
minskats	mins➊kats
minskning	minsk➊ning
minst	minst
minus	mi➊nus
minuter	mi➊nu➊ter
minuters	mi➊nu➊ters
misshandel	miss➊han➋del
misslyckats	miss➊lyck➋ats
misstag	miss➊tag
misstankar	miss➊tan➊kar
misstankarna	miss➊tan➊kar➊na
misstänker	miss➊tän➊ker
misstänks	miss➊tänks
misstänkt	miss➊tänkt
misstänkta	miss➊tänk➊ta
misstänktas	miss➊tänk➊tas
misstänkte	miss➊tänk➊te
misstänktes	miss➊tänk➊tes
misstänkts	miss➊tänkts
mitt	mitt
mitten	mit➊ten
Moderaterna	Mo➊de➊ra➊ter➊na
Moderaternas	Mo➊de➊ra➊ter➊nas
Mona	Mo➊na
Monas	Mo➊nas
mord	mord
mordet	mor➊det
Morgan	Mor➊gan
Morgans	Mor➊gans
morgon	mor➊gon
morgonen	mor➊go➊nen
morgonens	mor➊go➊nens
morgons	mor➊gons
morse	mor➊se
Moskva	Mos➊kva
Moskvas	Mos➊kvas
mot	mot
motstånd	mot➊stånd
motståndare	mot➊stån➊da➊re
motståndares	mot➊stån➊da➊res
motstånds	mot➊stånds
motsvarande	mot➊sva➊ran➊de
motsvarar	mot➊sva➊rar
Mubarak	Mu➊ba➋rak
Mubaraks	Mu➊ba➋raks
Mursi	Mur➊si
Mursis	Mur➊sis
musik	mu➊sik
muslimer	mus➊li➊mer
muslimers	mus➊li➊mers
muslimska	mus➊lims➊ka
mutor	mu➊tor
mycket	myck➊et
myndighet	myn➊dig➊het
myndigheten	myn➊dig➊he➊ten
myndighetens	myn➊dig➊he➊tens
myndigheter	myn➊dig➊he➊ter
myndigheterna	myn➊dig➊he➊ter➊na
myndigheternas	myn➊dig➊he➊ter➊nas
myndigheters	myn➊dig➊he➊ters
myndighets	myn➊dig➊hets
mål	mål
målet	må➊let
målets	må➊lets
månad	må➊nad
månaden	må➊na➊den
månadens	må➊na➊dens
månader	må➊na➊der
månaderna	må➊na➊der➊na
månadernas	må➊na➊der➊nas
månaders	må➊na➊ders
månads	må➊nads
måndag	mån➊dag
måndagen	mån➊da➊gen
måndagens	mån➊da➊gens
måndags	mån➊dags
många	många
mångas	mångas
mår	mår
måste	mås➊te
män	män
mängd	mängd
mängder	mäng➊der
männen	män➊nen
männens	män➊nens
människa	män➊ni➊ska
människas	män➊ni➊skas
människor	män➊ni➊skor
människorna	män➊ni➊skor➊na
människornas	män➊ni➊skor➊nas
människors	män➊ni➊skors
mäns	mäns
mänskliga	mänsk➊li➊ga
märks	märks
möjliga	möj➊li➊ga
möjligen	möj➊li➊gen
möjlighet	möj➊lig➊het
möjligheten	möj➊lig➊he➊ten
möjligheter	möj➊lig➊he➊ter
möjligheterna	möj➊lig➊he➊ter➊na
möjligheternas	möj➊lig➊he➊ter➊nas
möjligt	möj➊ligt
Möller	Möl➊ler
Möllers	Möl➊lers
möta	mö➊ta
mötas	mö➊tas
möte	mö➊te
möten	mö➊ten
möter	mö➊ter
mötes	mö➊tes
mötet	mö➊tet
mötets	mö➊tets
möts	möts
namn	namn
namnet	nam➊net
nationell	na➊tio➊nell
nationella	na➊tio➊nel➊la
NATO	NA➊TO
NATOs	NA➊TOs
natt	natt
natten	nat➊ten
nattens	nat➊tens
natts	natts
naturligtvis	na➋tur➊ligt➊vis
Naturvårdsverket	Na➋tur➊vårds➊ver➋ket
Naturvårdsverkets	Na➋tur➊vårds➊ver➋kets
ned	ned
Nederländerna	Ne➋der➊län➋der➋na
Nederländernas	Ne➋der➊län➋der➋nas
negativa	ne➊ga➊ti➊va
negativt	ne➊ga➊tivt
nej	nej
nekar	ne➊kar
ner	ner
nere	ne➊re
Netanyahu	Ne➊tanya➊hu
Netanyahus	Ne➊tanya➊hus
New	New
News	News
Nigeria	Ni➊ge➊ria
Nigerias	Ni➊ge➊rias
Nilsson	Nils➊son
Nilssons	Nils➊sons
nio	nio
nivå	ni➊vå
nivåer	ni➊vå➊er
nivån	ni➊vån
nog	nog
noga	no➊ga
Nordamerika	Nord➊ame➋ri➋ka
Nordamerikas	Nord➊ame➋ri➋kas
Nordea	Nor➊dea
Nordeas	Nor➊deas
nordiska	nor➊dis➊ka
Nordkorea	Nord➊ko➋rea
Nordkoreas	Nord➊ko➋reas
nordöstra	nord➊öst➋ra
Norge	Nor➊ge
Norges	Nor➊ges
normalt	nor➊malt
norr	norr
norra	nor➊ra
Norrbotten	Norr➊bot➋ten
Norrbottens	Norr➊bot➋tens
norska	nors➊ka
november	no➊vem➊ber
nuläget	nu➊lä➊get
numera	nu➊me➊ra
nuvarande	nu➊va➊ran➊de
nya	nya
nyanlända	ny➊an➊län➊da
nyanländas	ny➊an➊län➊das
nye	nye
Nyheter	Ny➊he➋ter
Nyheters	Ny➊he➋ters
nyhetsbyrån	ny➋hets➊by➋rån
nyhetsbyråns	ny➋hets➊by➋råns
nyligen	ny➊li➊gen
nytt	nytt
nytta	nyt➊ta
nyval	ny➊val
någon	nå➊gon
någons	nå➊gons
någonsin	nå➊gon➊sin
någonstans	nå➊gon➊stans
någonting	nå➊gon➊ting
något	nå➊got
några	någ➊ra
når	når
nått	nått
nåtts	nåtts
nämligen	näm➊li➊gen
när	när
nära	nä➊ra
närheten	när➊he➋ten
näringslivet	nä➋rings➊li➋vet
näringslivets	nä➋rings➊li➋vets
närmare	när➊ma➊re
närmast	när➊mast
närmaste	när➊mas➊te
närs	närs
närvarande	när➊va➊ran➊de
närvaro	när➊va➊ro
näst	näst
nästa	näs➊ta
nästan	näs➊tan
nätet	nä➊tet
nätets	nä➊tets
nätverk	nät➊verk
nödvändigt	nöd➊vän➊digt
nöjd	nöjd
nöjda	nöj➊da
oavsett	oav➊sett
Obama	Oba➊ma
Obamas	Oba➊mas
oberoende	obe➊ro➊en➊de
och	och
också	ock➊så
October	Oc➊to➊ber
oerhört	oer➊hört
offentlig	of➊fent➊lig
offentliga	of➊fent➊li➊ga
offentligas	of➊fent➊li➊gas
offentligt	of➊fent➊ligt
offer	of➊fer
offers	of➊fers
officiella	of➊fi➊ci➊el➊la
officiellt	of➊fi➊ci➊ellt
offren	off➊ren
offrens	off➊rens
ofta	of➊ta
oftare	of➊ta➊re
oftas	of➊tas
oftast	of➊tast
Ohly	Ohly
Ohlys	Ohlys
oklart	oklart
oktober	ok➊to➊ber
Ola	Ola
olagligt	olag➊ligt
olika	oli➊ka
olja	ol➊ja
Olof	Olof
Olofsson	Olofs➊son
Olofssons	Olofs➊sons
Olsson	Ols➊son
Olssons	Ols➊sons
olyckan	olyck➊an
olyckans	olyck➊ans
olyckor	olyck➊or
ombord	om➊bord
omedelbart	ome➊del➊bart
omfattande	om➊fat➊tan➊de
omkom	om➊kom
omkommit	om➊kom➊mit
omkring	om➊kring
område	om➊rå➊de
områden	om➊rå➊den
områdena	om➊rå➊de➊na
områdenas	om➊rå➊de➊nas
områdes	om➊rå➊des
området	om➊rå➊det
områdets	om➊rå➊dets
omröstning	om➊röst➊ning
omröstningen	om➊röst➊ning➊en
omröstningens	om➊röst➊ning➊ens
omsorg	om➊sorg
omsorgs	om➊sorgs
omvärlden	om➊värl➊den
omvärldens	om➊värl➊dens
omöjligt	omöj➊ligt
onsdag	ons➊dag
onsdagen	ons➊da➊gen
onsdagens	ons➊da➊gens
onsdags	ons➊dags
oppositionen	op➊po➊si➊tio➊nen
oppositionens	op➊po➊si➊tio➊nens
ord	ord
ordentligt	or➊dent➊ligt
order	or➊der
orders	or➊ders
ordförande	ord➊fö➊ran➊de
ordföranden	ord➊fö➊ran➊den
ordförandens	ord➊fö➊ran➊dens
ordförandes	ord➊fö➊ran➊des
ordning	ord➊ning
ordnings	ord➊nings
ords	ords
organisation	or➊ga➊ni➊sa➊tion
organisationen	or➊ga➊ni➊sa➊tio➊nen
organisationens	or➊ga➊ni➊sa➊tio➊nens
organisationer	or➊ga➊ni➊sa➊tio➊ner
organisationers	or➊ga➊ni➊sa➊tio➊ners
organisations	or➊ga➊ni➊sa➊tions
oro	oro
oroar	oro➊ar
orolig	oro➊lig
oroliga	oro➊li➊ga
oroligheterna	oro➊lig➊he➊ter➊na
oron	oron
orsak	or➊sak
orsakade	or➊sa➊ka➊de
orsakades	or➊sa➊ka➊des
orsakat	or➊sa➊kat
orsakats	or➊sa➊kats
Orsaken	Or➊sa➊ken
Oslo	Oslo
Oslos	Oslos
oss	oss
osäkerhet	osä➊ker➊het
osäkert	osä➊kert
osäkra	osäk➊ra
otroligt	otro➊ligt
ovanligt	ovan➊ligt
oväntat	ovän➊tat
Pakistan	Pa➊ki➊stan
Pakistans	Pa➊ki➊stans
palestinier	pa➊les➊ti➊ni➊er
palestinierna	pa➊les➊ti➊ni➊er➊na
palestiniernas	pa➊les➊ti➊ni➊er➊nas
palestiniers	pa➊les➊ti➊ni➊ers
palestinska	pa➊les➊tins➊ka
pappa	pap➊pa
pappas	pap➊pas
par	par
Paris	Pa➊ris
parlament	par➊la➊ment
parlamentet	par➊la➊men➊tet
parlamentets	par➊la➊men➊tets
parlaments	par➊la➊ments
parlamentsvalet	par➋la➋ments➊va➋let
parlamentsvalets	par➋la➋ments➊va➋lets
pars	pars
parter	par➊ter
parterna	par➊ter➊na
parternas	par➊ter➊nas
parters	par➊ters
parti	par➊ti
partier	par➊ti➊er
partierna	par➊ti➊er➊na
partiernas	par➊ti➊er➊nas
partiers	par➊ti➊ers
partiet	par➊ti➊et
partiets	par➊ti➊ets
partiledare	par➋ti➊le➋da➋re
partiledaren	par➋ti➊le➋da➋ren
partiledarens	par➋ti➊le➋da➋rens
partiledares	par➋ti➊le➋da➋res
partis	par➊tis
partisekreterare	par➋ti➊sek➋re➋te➋ra➋re
partisekreteraren	par➋ti➊sek➋re➋te➋ra➋ren
partisekreterarens	par➋ti➊sek➋re➋te➋ra➋rens
partisekreterares	par➋ti➊sek➋re➋te➋ra➋res
partisekreterarna	par➋ti➊sek➋re➋te➋rar➋na
partisekreterarposten	par➋ti➊sek➋re➋te➋rar➊pos➋ten
partisk	par➊tisk
pass	pass
passagerare	pas➊sa➊ge➊ra➊re
passagerares	pas➊sa➊ge➊ra➊res
patienten	pa➊ti➊en➊ten
patientens	pa➊ti➊en➊tens
patienter	pa➊ti➊en➊ter
patienterna	pa➊ti➊en➊ter➊na
patienternas	pa➊ti➊en➊ter➊nas
patienters	pa➊ti➊en➊ters
Patrik	Pa➊trik
Paul	Paul
Pauls	Pauls
pekar	pe➊kar
Peking	Pe➊king
Pekings	Pe➊kings
pengar	peng➊ar
pengarna	peng➊ar➊na
pengarnas	peng➊ar➊nas
pengars	peng➊ars
pension	pen➊sion
pensions	pen➊sions
pensionärer	pen➊sio➊nä➊rer
pensionärers	pen➊sio➊nä➊rers
per	per
period	pe➊ri➊od
perioden	pe➊ri➊o➊den
periodens	pe➊ri➊o➊dens
pers	pers
person	per➊son
personal	per➊so➊nal
personalen	per➊so➊na➊len
personalens	per➊so➊na➊lens
personals	per➊so➊nals
personen	per➊so➊nen
personens	per➊so➊nens
personer	per➊so➊ner
personerna	per➊so➊ner➊na
personernas	per➊so➊ner➊nas
personers	per➊so➊ners
personliga	per➋son➊li➋ga
persons	per➊sons
Persson	Pers➊son
Perssons	Pers➊sons
Peter	Pe➊ter
Peters	Pe➊ters
Petrén	Pet➊rén
Petréns	Pet➊réns
PKK	PKK
PKKs	PKKs
plan	plan
planen	pla➊nen
planens	pla➊nens
planer	pla➊ner
planerade	pla➊ne➊ra➊de
planerades	pla➊ne➊ra➊des
planerar	pla➊ne➊rar
planerat	pla➊ne➊rat
planerats	pla➊ne➊rats
planerna	pla➊ner➊na
planet	pla➊net
planets	pla➊nets
plans	plans
plats	plats
platsen	plat➊sen
platsens	plat➊sens
platser	plat➊ser
plus	plus
plötsligt	plöts➊ligt
pojkar	poj➊kar
pojkars	poj➊kars
pojke	poj➊ke
pojken	poj➊ken
pojkens	poj➊kens
pojkes	poj➊kes
Polen	Po➊len
Polens	Po➊lens
polis	po➊lis
polisen	po➊li➊sen
polisens	po➊li➊sens
poliser	po➊li➊ser
poliserna	po➊li➊ser➊na
polisernas	po➊li➊ser➊nas
polisers	po➊li➊sers
politik	po➊li➊tik
politiken	po➊li➊ti➊ken
politikens	po➊li➊ti➊kens
politiker	po➊li➊ti➊ker
politikerna	po➊li➊ti➊ker➊na
politikernas	po➊li➊ti➊ker➊nas
politikers	po➊li➊ti➊kers
politiks	po➊li➊tiks
politisk	po➊li➊tisk
politiska	po➊li➊tis➊ka
politiskt	po➊li➊tiskt
polska	pols➊ka
Portugal	Por➊tu➊gal
Portugals	Por➊tu➊gals
positiv	po➊si➊tiv
positiva	po➊si➊ti➊va
positivt	po➊si➊tivt
post	post
posten	pos➊ten
postens	pos➊tens
praktiken	prak➊ti➊ken
prata	pra➊ta
pratar	pra➊tar
pratas	pra➊tas
pratat	pra➊tat
pratats	pra➊tats
precis	pre➊cis
premiärminister	pre➋mi➋är➊mi➋nis➋ter
premiärministern	pre➋mi➋är➊mi➋nis➋tern
premiärministerns	pre➋mi➋är➊mi➋nis➋terns
premiärministers	pre➋mi➋är➊mi➋nis➋ters
presentera	pre➊sen➊te➊ra
presenterade	pre➊sen➊te➊ra➊de
presenterades	pre➊sen➊te➊ra➊des
presenterar	pre➊sen➊te➊rar
presenteras	pre➊sen➊te➊ras
president	pre➊si➊dent
presidenten	pre➊si➊den➊ten
presidentens	pre➊si➊den➊tens
presidents	pre➊si➊dents
presidentvalet	pre➋si➋dent➊va➋let
presidentvalets	pre➋si➋dent➊va➋lets
press	press
presskonferens	press➊kon➋fe➋rens
presskonferensen	press➊kon➋fe➋ren➋sen
presskonferensens	press➊kon➋fe➋ren➋sens
pressmeddelande	press➊med➋de➊lan➋de
princip	prin➊cip
pris	pris
priser	pri➊ser
priserna	pri➊ser➊na
priset	pri➊set
prisets	pri➊sets
privat	pri➊vat
privata	pri➊va➊ta
problem	pro➊blem
problemen	pro➊ble➊men
problemet	pro➊ble➊met
problemets	pro➊ble➊mets
problems	pro➊blems
procent	pro➊cent
procentenheter	pro➋cen➋ten➊he➋ter
procentenheters	pro➋cen➋ten➊he➋ters
procents	pro➊cents
process	pro➊cess
processen	pro➊ces➊sen
processens	pro➊ces➊sens
produkter	pro➊duk➊ter
produktion	pro➊duk➊tion
produktionen	pro➊duk➊tio➊nen
produktions	pro➊duk➊tions
professor	pro➊fes➊sor
prognos	pro➊gnos
prognosen	pro➊gno➊sen
prognosens	pro➊gno➊sens
program	pro➊gram
programmet	pro➊gram➊met
programmets	pro➊gram➊mets
programs	pro➊grams
projekt	pro➊jekt
projektet	pro➊jek➊tet
projektets	pro➊jek➊tets
protest	pro➊test
protester	pro➊te➊ster
protesterna	pro➊te➊ster➊na
protesternas	pro➊te➊ster➊nas
protesters	pro➊te➊sters
provinsen	pro➊vin➊sen
provinsens	pro➊vin➊sens
pröva	prö➊va
prövas	prö➊vas
publiceras	pu➊bli➊ce➊ras
punkter	punk➊ter
punkters	punk➊ters
Putin	Pu➊tin
Putins	Pu➊tins
pågick	på➊gick
pågående	på➊gå➊en➊de
pågår	på➊går
pågått	på➊gått
påpekar	på➊pe➊kar
påverka	på➊ver➊ka
påverkar	på➊ver➊kar
påverkas	på➊ver➊kas
PÄR	PÄR
Qaida	Qai➊da
Qaidas	Qai➊das
rad	rad
Radio	Ra➊dio
Radios	Ra➊dios
rakt	rakt
Ramberg	Ram➊berg
Rambergs	Ram➊bergs
rapport	rap➊port
rapporten	rap➊por➊ten
rapportens	rap➊por➊tens
rapporter	rap➊por➊ter
rapporterade	rap➊por➊te➊ra➊de
rapporterades	rap➊por➊te➊ra➊des
rapporterar	rap➊por➊te➊rar
rapporterars	rap➊por➊te➊rars
rapporteras	rap➊por➊te➊ras
rapporterat	rap➊por➊te➊rat
rapporterats	rap➊por➊te➊rats
rapportering	rap➊por➊te➊ring
reagerar	re➊a➊ge➊rar
reaktioner	re➊ak➊tio➊ner
rebeller	re➊bel➊ler
rebellerna	re➊bel➊ler➊na
rebellernas	re➊bel➊ler➊nas
reda	re➊da
redan	re➊dan
redas	re➊das
redo	re➊do
reformer	re➊for➊mer
regering	re➊ge➊ring
regeringar	re➊ge➊ring➊ar
regeringars	re➊ge➊ring➊ars
regeringen	re➊ge➊ring➊en
regeringens	re➊ge➊ring➊ens
regerings	re➊ge➊rings
regeringsorgan	re➋ge➋rings➊or➋gan
regeringsorganet	re➋ge➋rings➊or➋ga➋net
regeringspartier	re➋ge➋rings➊par➋ti➋er
regeringspartierna	re➋ge➋rings➊par➋ti➋er➋na
regeringspartiernas	re➋ge➋rings➊par➋ti➋er➋nas
regeringspartiet	re➋ge➋rings➊par➋ti➋et
regeringspartiets	re➋ge➋rings➊par➋ti➋ets
regeringspartner	re➋ge➋rings➊part➋ner
regeringspartnern	re➋ge➋rings➊part➋nern
regeringspartners	re➋ge➋rings➊part➋ners
regeringsplan	re➋ge➋rings➊plan
regeringsplanet	re➋ge➋rings➊pla➋net
regeringsplattform	re➋ge➋rings➊platt➋form
regeringsplattformen	re➋ge➋rings➊platt➋for➋men
regeringspolitik	re➋ge➋rings➊po➋li➋tik
regeringspolitiken	re➋ge➋rings➊po➋li➋ti➋ken
regeringsprogram	re➋ge➋rings➊pro➋gram
regeringsprogrammet	re➋ge➋rings➊pro➋gram➋met
regimen	re➊gi➊men
regimens	re➊gi➊mens
region	re➊gi➊on
regionala	re➊gi➊o➊na➊la
regionen	re➊gi➊o➊nen
regionens	re➊gi➊o➊nens
regioner	re➊gi➊o➊ner
regioners	re➊gi➊o➊ners
regions	re➊gi➊ons
regler	reg➊ler
reglerna	reg➊ler➊na
regn	regn
Reinfeldt	Rein➊feldt
Reinfeldts	Rein➊feldts
rejält	re➊jält
relation	re➊la➊tion
relationer	re➊la➊tio➊ner
relationerna	re➊la➊tio➊ner➊na
relationernas	re➊la➊tio➊ner➊nas
relations	re➊la➊tions
relativt	re➊la➊tivt
religiösa	re➊li➊giö➊sa
rent	rent
reporter	re➊por➊ter
reporters	re➊por➊ters
representanter	re➊pre➊sen➊tan➊ter
republikanerna	re➊pu➊bli➊ka➊ner➊na
republikanernas	re➊pu➊bli➊ka➊ner➊nas
resa	re➊sa
resan	re➊san
resans	re➊sans
resas	re➊sas
resenärer	re➊se➊nä➊rer
resenärers	re➊se➊nä➊rers
reser	re➊ser
resor	re➊sor
respekt	re➊spekt
respektive	re➊spek➊ti➊ve
resten	res➊ten
resultat	re➊sul➊tat
resultaten	re➊sul➊ta➊ten
resultatens	re➊sul➊ta➊tens
resultatet	re➊sul➊ta➊tet
resurser	re➊sur➊ser
Reuters	Reu➊ters
Richard	Ri➊chard
Richards	Ri➊chards
Rights	Rights
rika	ri➊ka
rikas	ri➊kas
Riksbanken	Riks➊ban➋ken
Riksbankens	Riks➊ban➋kens
riksdagen	riks➊da➋gen
riksdagens	riks➊da➋gens
riksförbund	riks➊för➋bund
riksförbunds	riks➊för➋bunds
riktade	rik➊ta➊de
riktades	rik➊ta➊des
riktar	rik➊tar
riktigt	rik➊tigt
riktlinjer	rikt➊lin➋jer
riktning	rikt➊ning
rimligt	rim➊ligt
ringa	ringa
ringas	ringas
risk	risk
risken	ris➊ken
risker	ris➊ker
riskerar	ris➊ke➊rar
riskerna	ris➊ker➊na
risks	risks
Robert	Ro➊bert
Roberts	Ro➊berts
roll	roll
Romson	Rom➊son
Romsons	Rom➊sons
rum	rum
Rumänien	Ru➊mä➊ni➊en
Rumäniens	Ru➊mä➊ni➊ens
runt	runt
rysk	rysk
ryska	rys➊ka
ryske	rys➊ke
Ryssland	Ryss➊land
Rysslands	Ryss➊lands
råd	råd
råder	rå➊der
rådet	rå➊det
rådets	rå➊dets
rådgivare	råd➊gi➊va➊re
råds	råds
räcker	räck➊er
rädd	rädd
rädda	räd➊da
räddas	räd➊das
räddningstjänsten	rädd➋nings➊tjäns➋ten
räddningstjänstens	rädd➋nings➊tjäns➋tens
rädsla	räds➊la
räkna	räk➊na
räknar	räk➊nar
räknas	räk➊nas
räknat	räk➊nat
räknats	räk➊nats
ränta	rän➊ta
räntan	rän➊tan
räntans	rän➊tans
rätt	rätt
rätta	rät➊ta
rättas	rät➊tas
rättegång	rät➋te➊gång
rättegången	rät➋te➊gång➋en
rättegångens	rät➋te➊gång➋ens
rätten	rät➊ten
rättens	rät➊tens
rättigheter	rät➋tig➊he➋ter
rättigheters	rät➋tig➊he➋ters
rätts	rätts
Röda	Rö➊da
rödgröna	röd➊grö➋na
rödgrönas	röd➊grö➋nas
rör	rör
röra	rö➊ra
röras	rö➊ras
rörelsen	rö➊rel➊sen
rörelsens	rö➊rel➊sens
rörs	rörs
röst	röst
rösta	rös➊ta
röstade	rös➊ta➊de
röstades	rös➊ta➊des
röstar	rös➊tar
röstas	rös➊tas
röstat	rös➊tat
röstats	rös➊tats
röster	rös➊ter
rösterna	rös➊ter➊na
rösters	rös➊ters
rösts	rösts
SAAB	SAAB
SAABs	SAABs
sade	sa➊de
sades	sa➊des
sagt	sagt
sagts	sagts
Sahlin	Sah➊lin
Sahlins	Sah➊lins
sak	sak
saken	sa➊ken
sakens	sa➊kens
saker	sa➊ker
saknar	sak➊nar
saknas	sak➊nas
samarbeta	sam➊ar➊be➊ta
samarbete	sam➊ar➊be➊te
samarbetet	sam➊ar➊be➊tet
samarbetets	sam➊ar➊be➊tets
samband	sam➊band
samhälle	sam➊häl➊le
samhälles	sam➊häl➊les
samhället	sam➊häl➊let
samhällets	sam➊häl➊lets
samla	sam➊la
samlade	sam➊la➊de
samlades	sam➊la➊des
samlas	sam➊las
samlats	sam➊lats
samma	sam➊ma
samman	sam➊man
sammanlagt	sam➋man➊lagt
samt	samt
samtal	sam➊tal
samtalen	sam➊ta➊len
samtalens	sam➊ta➊lens
samtals	sam➊tals
samtidigt	sam➊ti➊digt
samtliga	samt➊li➊ga
San	San
sanktioner	sank➊tio➊ner
sanktionerna	sank➊tio➊ner➊na
sanktionernas	sank➊tio➊ner➊nas
sannolikt	san➊no➊likt
Sara	Sa➊ra
Saras	Sa➊ras
Sarkozy	Sar➊ko➊zy
Sarkozys	Sar➊ko➊zys
SAS	SAS
satsa	sat➊sa
satsar	sat➊sar
satsas	sat➊sas
satsning	sats➊ning
satsningar	sats➊ning➊ar
satsningen	sats➊ning➊en
satsningens	sats➊ning➊ens
satt	satt
satte	sat➊te
sattes	sat➊tes
satts	satts
Saudiarabien	Sau➋di➊ara➋bi➋en
Saudiarabiens	Sau➋di➊ara➋bi➋ens
Schweiz	Schweiz
SEB	SEB
Sebastian	Se➊bas➊ti➊an
SEBs	SEBs
sedan	se➊dan
seger	se➊ger
sektorn	sek➊torn
sektorns	sek➊torns
sen	sen
senare	se➊na➊re
senast	se➊nast
senaste	se➊nas➊te
senaten	se➊na➊ten
senatens	se➊na➊tens
sent	sent
september	sep➊tem➊ber
septembers	sep➊tem➊bers
ser	ser
Serbien	Ser➊bi➊en
Serbiens	Ser➊bi➊ens
service	ser➊vice
services	ser➊vices
ses	ses
sett	sett
setts	setts
sex	sex
sexuella	sex➊u➊el➊la
sexuellt	sex➊u➊ellt
sida	si➊da
sidan	si➊dan
sidans	si➊dans
sidas	si➊das
sidor	si➊dor
sidors	si➊dors
siffra	siff➊ra
siffran	siff➊ran
siffror	siff➊ror
siffrorna	siff➊ror➊na
sig	sig
signaler	sig➊na➊ler
sikt	sikt
sin	sin
sina	si➊na
sista	sis➊ta
sitt	sitt
sitta	sit➊ta
sittande	sit➊tan➊de
sittandes	sit➊tan➊des
sitter	sit➊ter
sitts	sitts
situation	si➊tua➊tion
situationen	si➊tua➊tio➊nen
situationens	si➊tua➊tio➊nens
sju	sju
sjuk	sjuk
sjuka	sju➊ka
sjukas	sju➊kas
sjukdom	sjuk➊dom
sjukdomar	sjuk➊do➊mar
sjukdomars	sjuk➊do➊mars
sjukdomen	sjuk➊do➊men
sjukdomens	sjuk➊do➊mens
sjukhus	sjuk➊hus
sjukhuset	sjuk➊hu➊set
sjukhusets	sjuk➊hu➊sets
sjukvård	sjuk➊vård
sjukvården	sjuk➊vår➊den
sjukvårdens	sjuk➊vår➊dens
sjukvårds	sjuk➊vårds
sjunker	sjun➊ker
sjunkit	sjun➊kit
själv	själv
själva	själ➊va
självklart	själv➊klart
självmordsbombare	själv➋mords➊bom➋ba➋re
självmordsbombares	själv➋mords➊bom➋ba➋res
självständighet	själv➊stän➋dig➊het
självständighets	själv➊stän➋dig➊hets
sjönk	sjönk
Sjöstedt	Sjö➊stedt
Sjöstedts	Sjö➊stedts
Sjöström	Sjö➊ström
Sjöströms	Sjö➊ströms
ska	ska
skada	ska➊da
skadade	ska➊da➊de
skadades	ska➊da➊des
skadas	ska➊das
skadats	ska➊dats
skadestånd	ska➊de➊stånd
skador	ska➊dor
skaffa	skaf➊fa
skaffas	skaf➊fas
skall	skall
Skandia	Skan➊dia
Skandias	Skan➊dias
skapa	ska➊pa
skapar	ska➊par
skapas	ska➊pas
skapat	ska➊pat
skapats	ska➊pats
skarp	skarp
skatt	skatt
skatten	skat➊ten
skattens	skat➊tens
skatter	skat➊ter
Skatteverket	Skat➋te➊ver➋ket
Skatteverkets	Skat➋te➊ver➋kets
ske	ske
skedde	sked➊de
sker	sker
skett	skett
skicka	skicka
skickar	skick➊ar
skickas	skickas
skickat	skick➊at
skickats	skick➊ats
skiljer	skil➊jer
skillnad	skill➊nad
skillnaden	skill➊na➊den
skillnader	skill➊na➊der
skjuta	skju➊ta
skjutas	skju➊tas
skjutit	skju➊tit
skjutits	skju➊tits
SKL	SKL
SKLs	SKLs
skog	skog
skogen	sko➊gen
skogens	sko➊gens
skogs	skogs
skola	sko➊la
skolan	sko➊lan
skolans	sko➊lans
skolas	sko➊las
skolor	sko➊lor
skolorna	sko➊lor➊na
skolornas	sko➊lor➊nas
skolors	sko➊lors
Skolverket	Skol➊ver➋ket
Skolverkets	Skol➊ver➋kets
skott	skott
skottlossning	skott➊loss➊ning
skrev	skrev
skrevs	skrevs
skriva	skri➊va
skrivas	skri➊vas
skriver	skri➊ver
skrivit	skri➊vit
skrivits	skri➊vits
skulden	skul➊den
skulder	skul➊der
skulle	skul➊le
skydd	skydd
skydda	skyd➊da
skyddas	skyd➊das
skydds	skydds
skyldig	skyl➊dig
skyldiga	skyl➊di➊ga
Skåne	Skå➊ne
Skånes	Skå➊nes
skäl	skäl
skälet	skä➊let
skärpa	skär➊pa
skärpas	skär➊pas
sköt	sköt
sköts	sköts
slag	slag
slagit	sla➊git
slagits	sla➊gits
slags	slags
slippa	slip➊pa
slog	slog
slogs	slogs
slut	slut
sluta	slu➊ta
slutade	slu➊ta➊de
slutar	slu➊tar
slutas	slu➊tas
slutet	slu➊tet
sluts	sluts
slutsatsen	slut➊sat➋sen
slå	slå
slår	slår
slås	slås
släppa	släp➊pa
släppas	släp➊pas
släpptes	släpp➊tes
släppts	släppts
SMHI	SMHI
SMHIs	SMHIs
sms	sms
små	små
snabb	snabb
snabba	snab➊ba
snabbare	snab➊ba➊re
snabbas	snab➊bas
snabbs	snabbs
snabbt	snabbt
snarare	sna➊ra➊re
snart	snart
snö	snö
sociala	so➊ci➊a➊la
socialdemokrat	so➋ci➋al➊de➋mo➋krat
socialdemokraten	so➋ci➋al➊de➋mo➋kra➋ten
socialdemokrater	so➋ci➋al➊de➋mo➋kra➋ter
socialdemokratern	so➋ci➋al➊de➋mo➋kra➋tern
Socialdemokraterna	So➋ci➋al➊de➋mo➋kra➋ter➋na
Socialdemokraternas	So➋ci➋al➊de➋mo➋kra➋ter➋nas
socialdemokraterns	so➋ci➋al➊de➋mo➋kra➋terns
socialdemokraters	so➋ci➋al➊de➋mo➋kra➋ters
socialdemokrati	so➋ci➋al➊de➋mo➋kra➋ti
socialdemokratisk	so➋ci➋al➊de➋mo➋kra➋tisk
socialdemokratiska	so➋ci➋al➊de➋mo➋kra➋tis➋ka
socialdemokratiske	so➋ci➋al➊de➋mo➋kra➋tis➋ke
socialdemokratiskt	so➋ci➋al➊de➋mo➋kra➋tiskt
Socialstyrelsen	So➋ci➋al➊sty➋rel➋sen
Socialstyrelsens	So➋ci➋al➊sty➋rel➋sens
soldater	sol➊da➊ter
soldaterna	sol➊da➊ter➊na
soldaternas	sol➊da➊ter➊nas
soldaters	sol➊da➊ters
som	som
Somalia	So➊ma➊lia
Somalias	So➊ma➊lias
sommar	som➊mar
sommaren	som➊ma➊ren
sommarens	som➊ma➊rens
sommars	som➊mars
somras	som➊ras
son	son
Sonera	So➊ne➊ra
Soneras	So➊ne➊ras
sons	sons
Spanien	Spa➊ni➊en
Spaniens	Spa➊ni➊ens
spanska	spans➊ka
spara	spa➊ra
sparas	spa➊ras
speciellt	spe➊ci➊ellt
spel	spel
spela	spe➊la
spelar	spe➊lar
spelas	spe➊las
spels	spels
sprida	spri➊da
spridas	spri➊das
spår	spår
stad	stad
staden	sta➊den
stadens	sta➊dens
stads	stads
Staffan	Staf➊fan
stan	stan
stanna	stan➊na
stannar	stan➊nar
stannas	stan➊nas
stans	stans
stark	stark
starka	star➊ka
starkare	star➊ka➊re
starkt	starkt
starta	star➊ta
startade	star➊ta➊de
startades	star➊ta➊des
startar	star➊tar
startas	star➊tas
stat	stat
staten	sta➊ten
statens	sta➊tens
statistik	sta➊tis➊tik
statistiken	sta➊tis➊ti➊ken
statistikens	sta➊tis➊ti➊kens
statlig	stat➊lig
statliga	stat➊li➊ga
statligt	stat➊ligt
stats	stats
statsminister	stats➊mi➋nis➋ter
statsministern	stats➊mi➋nis➋tern
statsministerns	stats➊mi➋nis➋terns
statsministers	stats➊mi➋nis➋ters
Stefan	Ste➊fan
Stefans	Ste➊fans
steg	steg
Sten	Sten
stiga	sti➊ga
stigande	sti➊gan➊de
stiger	sti➊ger
stigit	sti➊git
stilla	stil➊la
stillas	stil➊las
Stockholm	Stock➊holm
Stockholms	Stock➊holms
Stockholmsbörsen	Stock➋holms➊bör➋sen
Stockholmsbörsens	Stock➋holms➊bör➋sens
stod	stod
stopp	stopp
stoppa	stop➊pa
stoppas	stop➊pas
stor	stor
stora	sto➊ra
storas	sto➊ras
storbolag	stor➊bo➋lag
storbolagen	stor➊bo➋la➋gen
storbolagens	stor➊bo➋la➋gens
storbrand	stor➊brand
storbranden	stor➊bran➋den
Storbritannien	Stor➊bri➋tan➋ni➋en
Storbritanniens	Stor➊bri➋tan➋ni➋ens
stormen	stor➊men
stormens	stor➊mens
stort	stort
storts	storts
straff	straff
strategi	stra➊te➊gi
strax	strax
strejk	strejk
strejken	strej➊ken
strejkens	strej➊kens
strid	strid
strider	stri➊der
striderna	stri➊der➊na
stridernas	stri➊der➊nas
strids	strids
studenter	stu➊den➊ter
studenters	stu➊den➊ters
studie	stu➊die
studien	stu➊di➊en
studiens	stu➊di➊ens
studier	stu➊di➊er
studies	stu➊dies
stund	stund
stunds	stunds
stycken	styck➊en
styr	styr
styra	sty➊ra
styrande	sty➊ran➊de
styrandes	sty➊ran➊des
styras	sty➊ras
styrelse	sty➊rel➊se
styrelsen	sty➊rel➊sen
styrelsens	sty➊rel➊sens
styrelses	sty➊rel➊ses
styrka	styr➊ka
styrkan	styr➊kan
styrkans	styr➊kans
styrkas	styr➊kas
styrkor	styr➊kor
styrkorna	styr➊kor➊na
styrkornas	styr➊kor➊nas
styrkors	styr➊kors
styrs	styrs
stå	stå
står	står
stått	stått
städer	stä➊der
städerna	stä➊der➊na
städernas	stä➊der➊nas
städers	stä➊ders
ställa	stäl➊la
ställas	stäl➊las
ställde	ställ➊de
ställdes	ställ➊des
ställen	stäl➊len
ställer	stäl➊ler
stället	stäl➊let
ställning	ställ➊ning
ställs	ställs
ställt	ställt
ställts	ställts
stämmer	stäm➊mer
ständigt	stän➊digt
stänga	stänga
stängas	stängas
stängda	stäng➊da
stängt	stängt
stängts	stängts
stärka	stär➊ka
stärkas	stär➊kas
stöd	stöd
stödet	stö➊det
stödja	stöd➊ja
stödjas	stöd➊jas
stödjer	stöd➊jer
stöds	stöds
större	stör➊re
störst	störst
största	störs➊ta
Sudan	Su➊dan
Sudans	Su➊dans
suttit	sut➊tit
svag	svag
svar	svar
svara	sva➊ra
svarade	sva➊ra➊de
svarar	sva➊rar
svaras	sva➊ras
svarat	sva➊rat
svaret	sva➊ret
svars	svars
svart	svart
svarta	svar➊ta
svartas	svar➊tas
Sven	Sven
Svens	Svens
svensk	svensk
svenska	svens➊ka
svenskar	svens➊kar
svenskarna	svens➊kar➊na
svenskarnas	svens➊kar➊nas
svenskars	svens➊kars
svensks	svensks
svenskt	svenskt
Svensson	Svens➊son
Svenssons	Svens➊sons
Sverige	Sve➊ri➊ge
Sverigebesök	Sve➋ri➋ge➊be➋sök
Sverigebesöket	Sve➋ri➋ge➊be➋sö➋ket
Sverigebilden	Sve➋ri➋ge➊bil➋den
Sverigedemokraterna	Sve➋ri➋ge➊de➋mo➋kra➋ter➋na
Sverigedemokraternas	Sve➋ri➋ge➊de➋mo➋kra➋ter➋nas
Sverigedemokratiska	Sve➋ri➋ge➊de➋mo➋kra➋tis➋ka
Sverigefinal	Sve➋ri➋ge➊fi➋nal
sverigefinnar	sve➋ri➋ge➊fin➋nar
sverigefinnarna	sve➋ri➋ge➊fin➋nar➋na
sverigefinska	sve➋ri➋ge➊fins➋ka
Sverigeflyg	Sve➋ri➋ge➊flyg
Sverigefonder	Sve➋ri➋ge➊fon➋der
Sverigefonderna	Sve➋ri➋ge➊fon➋der➋na
Sverigekarta	Sve➋ri➋ge➊kar➋ta
Sverigekartan	Sve➋ri➋ge➊kar➋tan
Sverigemöte	Sve➋ri➋ge➊mö➋te
Sverigemötet	Sve➋ri➋ge➊mö➋tet
Sverigeprogram	Sve➋ri➋ge➊pro➋gram
Sveriges	Sve➊ri➊ges
Sverigevän	Sve➋ri➋ge➊vän
Sverigevänner	Sve➋ri➋ge➊vän➋ner
SVT	SVT
SVTs	SVTs
svår	svår
svåra	svå➊ra
svårare	svå➊ra➊re
svårt	svårt
Swedbank	Swed➊bank
Swedbanks	Swed➊banks
Sydafrika	Syd➊af➊ri➊ka
Sydafrikas	Syd➊af➊ri➊kas
Sydkorea	Syd➊ko➊rea
Sydkoreas	Syd➊ko➊reas
syftar	syf➊tar
syfte	syf➊te
Syftet	Syf➊tet
syn	syn
syns	syns
Syrien	Sy➊ri➊en
Syriens	Sy➊ri➊ens
syriska	sy➊ris➊ka
system	sys➊tem
systemet	sys➊te➊met
systemets	sys➊te➊mets
systems	sys➊tems
sådan	så➊dan
sådana	så➊da➊na
sådant	så➊dant
såg	såg
sågs	sågs
såväl	så➊väl
säga	sä➊ga
sägas	sä➊gas
säger	sä➊ger
sägs	sägs
säker	sä➊ker
säkerhet	sä➊ker➊het
säkerheten	sä➊ker➊he➊ten
säkerhetens	sä➊ker➊he➊tens
säkerhets	sä➊ker➊hets
säkerhetsråd	sä➋ker➋hets➊råd
säkerhetsrådet	sä➋ker➋hets➊rå➋det
säkerhetsrådets	sä➋ker➋hets➊rå➋dets
säkerhetsråds	sä➋ker➋hets➊råds
säkerhetsstyrkor	sä➋ker➋hets➊styr➋kor
säkerhetstjänsten	sä➋ker➋hets➊tjäns➋ten
säkerhetstjänstens	sä➋ker➋hets➊tjäns➋tens
säkert	sä➊kert
säkra	säk➊ra
säkras	säk➊ras
sälja	säl➊ja
säljas	säl➊jas
säljer	säl➊jer
säljs	säljs
sällan	säl➊lan
sämre	säm➊re
sänka	sän➊ka
sänkas	sän➊kas
sänkt	sänkt
sänkta	sänk➊ta
sänkts	sänkts
Säpo	Sä➊po
Säpos	Sä➊pos
särskild	sär➊skild
särskilda	sär➊skil➊da
särskilt	sär➊skilt
sätt	sätt
sätta	sät➊ta
sättas	sät➊tas
sätter	sät➊ter
sättet	sät➊tet
sätts	sätts
söder	sö➊der
Södertälje	Sö➋der➊täl➋je
Södertäljes	Sö➋der➊täl➋jes
södra	söd➊ra
söka	sö➊ka
sökas	sö➊kas
söker	sö➊ker
sökt	sökt
sökts	sökts
söndag	sön➊dag
söndagen	sön➊da➊gen
söndagens	sön➊da➊gens
söndags	sön➊dags
sönder	sön➊der
Sören	Sö➊ren
tack	tack
tag	tag
taget	ta➊get
tagit	ta➊git
tagits	ta➊gits
tags	tags
tak	tak
taket	ta➊ket
takt	takt
tal	tal
tala	ta➊la
talade	ta➊la➊de
talades	ta➊la➊des
talar	ta➊lar
talas	ta➊las
talat	ta➊lat
talats	ta➊lats
talesman	ta➋les➊man
talesperson	ta➋les➊per➋son
talet	ta➊let
talets	ta➊lets
talibanerna	ta➊li➊ba➊ner➊na
talibanernas	ta➊li➊ba➊ner➊nas
tals	tals
tankar	tan➊kar
tanke	tan➊ke
Tanken	Tan➊ken
tappat	tap➊pat
tappats	tap➊pats
tar	tar
tas	tas
tass	tass
tecken	teck➊en
teknik	tek➊nik
tekniks	tek➊niks
tekniska	tek➊nis➊ka
telefon	te➊le➊fon
Telia	Te➊lia
Telias	Te➊lias
terrordåd	ter➋ror➊dåd
terrorism	ter➊ro➊rism
terrorister	ter➊ro➊ris➊ter
terroristers	ter➊ro➊ris➊ters
Thailand	Thai➊land
Thailands	Thai➊lands
that	that
the	the
Thomas	Tho➊mas
tid	tid
tiden	ti➊den
tidens	ti➊dens
tider	ti➊der
tiders	ti➊ders
tidigare	ti➊di➊ga➊re
tidigt	ti➊digt
tidning	tid➊ning
tidningar	tid➊ning➊ar
tidningars	tid➊ning➊ars
tidningen	tid➊ning➊en
tidningens	tid➊ning➊ens
tidnings	tid➊nings
tids	tids
till	till
tillbaka	till➊ba➊ka
tillfälle	till➊fäl➊le
tillfällen	till➊fäl➊len
tillfälliga	till➊fäl➊li➊ga
tillfälligt	till➊fäl➊ligt
tillgång	till➊gång
tillgångar	till➊gång➊ar
tillhör	till➊hör
tillräckligt	till➊räck➊ligt
tills	tills
tillsammans	till➊sam➊mans
tillstånd	till➊stånd
tillväxt	till➊växt
tillväxten	till➊väx➊ten
tillväxtens	till➊väx➊tens
Times	Times
timmar	tim➊mar
timmars	tim➊mars
timme	tim➊me
timmes	tim➊mes
tingsrätt	tings➊rätt
tingsrätten	tings➊rät➋ten
tingsrättens	tings➊rät➋tens
tingsrätts	tings➊rätts
tio	tio
tiotal	tio➊tal
tiotals	tio➊tals
tiotusentals	tio➊tu➊sen➊tals
tisdag	tis➊dag
tisdagen	tis➊da➊gen
tisdagens	tis➊da➊gens
tisdags	tis➊dags
titta	tit➊ta
tittar	tit➊tar
tittas	tit➊tas
tjäna	tjä➊na
tjänar	tjä➊nar
tjänas	tjä➊nas
tjänst	tjänst
tjänstemän	tjäns➊te➊män
tjänstemäns	tjäns➊te➊mäns
tjänster	tjäns➊ter
Tobias	To➊bias
tog	tog
togs	togs
tolv	tolv
Tomas	Tomas
Tommy	Tommy
ton	ton
tons	tons
Tony	Tony
toppmöte	topp➊mö➊te
toppmötet	topp➊mö➊tet
toppmötets	topp➊mö➊tets
torget	tor➊get
torgets	tor➊gets
torsdag	tors➊dag
torsdagen	tors➊da➊gen
torsdagens	tors➊da➊gens
torsdags	tors➊dags
tortyr	tor➊tyr
totala	to➊ta➊la
totalt	to➊talt
trafik	tra➊fik
trafiken	tra➊fi➊ken
trafikens	tra➊fi➊kens
Trafikverket	Tra➊fi➊k➊ver➊ket
Trafikverkets	Tra➊fi➊k➊ver➊kets
tre	tre
tredje	tred➊je
tredjedel	tred➊je➊del
tredjedels	tred➊je➊dels
trenden	tren➊den
Tripoli	Tri➊po➊li
Tripolis	Tri➊po➊lis
tro	tro
trodde	trod➊de
troddes	trod➊des
troligen	tro➊li➊gen
Trollhättan	Troll➊hät➋tan
Trollhättans	Troll➊hät➋tans
tror	tror
tros	tros
trots	trots
Trump	Trump
Trumps	Trumps
trupper	trup➊per
truppers	trup➊pers
trycket	tryck➊et
träd	träd
träffa	träf➊fa
träffade	träf➊fa➊de
träffades	träf➊fa➊des
träffar	träf➊far
träffas	träf➊fas
träffat	träf➊fat
träffats	träf➊fats
tunga	tunga
Tunisien	Tu➊ni➊si➊en
Tunisiens	Tu➊ni➊si➊ens
tur	tur
turister	tu➊ris➊ter
turisters	tu➊ris➊ters
Turkiet	Tur➊ki➊et
Turkiets	Tur➊ki➊ets
turkiska	tur➊kis➊ka
tusen	tu➊sen
tusentals	tu➋sen➊tals
tvinga	tvinga
tvingades	tving➊a➊des
tvingas	tvingas
tvingats	tving➊ats
två	två
tvärtom	tvärt➊om
Twitter	Twit➊ter
Twitters	Twit➊ters
tycker	tyck➊er
tycks	tycks
tyckte	tyck➊te
tycktes	tyck➊tes
tyder	ty➊der
tydlig	tyd➊lig
tydliga	tyd➊li➊ga
tydligare	tyd➊li➊ga➊re
tydligt	tyd➊ligt
typ	typ
typen	typ➊en
typer	typ➊er
tysk	tysk
tyska	tys➊ka
Tyskland	Tysk➊land
Tysklands	Tysk➊lands
tyvärr	ty➊värr
tåg	tåg
tåget	tå➊get
tågets	tå➊gets
tågs	tågs
tårgas	tår➊gas
tänka	tän➊ka
tänkas	tän➊kas
tänker	tän➊ker
tänkt	tänkt
Uddén	Uddén
Uddéns	Uddéns
Ukraina	Ukrai➊na
Ukrainas	Ukrai➊nas
ukrainska	ukrains➊ka
Ulf	Ulf
Umeå	Umeå
Umeås	Umeås
undan	un➊dan
undantag	un➊dan➊tag
undantags	un➊dan➊tags
under	un➊der
underlätta	un➋der➊lät➋ta
underlättas	un➋der➊lät➋tas
unders	un➊ders
undersöka	un➋der➊sö➋ka
undersökas	un➋der➊sö➋kas
undersökning	un➋der➊sök➋ning
undersökningar	un➋der➊sök➋ning➋ar
undersökningen	un➋der➊sök➋ning➋en
undersökningens	un➋der➊sök➋ning➋ens
undersöknings	un➋der➊sök➋nings
undrar	und➊rar
undvika	und➊vi➊ka
undvikas	und➊vi➊kas
ung	ung
unga	unga
ungas	ungas
ungdomar	ung➊do➊mar
ungdomars	ung➊do➊mars
ungefär	un➊ge➊fär
unionen	uni➊o➊nen
unionens	uni➊o➊nens
universitet	uni➊ver➊si➊tet
universitets	uni➊ver➊si➊tets
upp	upp
Uppdaterad	Upp➊da➊te➊rad
uppdrag	upp➊drag
uppdraget	upp➊dra➊get
uppdragets	upp➊dra➊gets
uppe	uppe
uppehållstillstånd	uppe➋hålls➊till➋stånd
uppemot	upp➊emot
uppenbart	uppen➊bart
uppfattning	upp➊fatt➊ning
uppgav	upp➊gav
uppgavs	upp➊gavs
uppger	upp➊ger
uppges	upp➊ges
uppgift	upp➊gift
uppgiften	upp➊gif➋ten
uppgifter	upp➊gif➋ter
uppgifterna	upp➊gif➋ter➋na
uppgifternas	upp➊gif➋ter➋nas
uppgörelse	upp➊gö➋rel➋se
uppgörelsen	upp➊gö➋rel➋sen
uppgörelsens	upp➊gö➋rel➋sens
upplever	upp➊le➋ver
uppmanade	upp➊ma➋na➋de
uppmanades	upp➊ma➋na➋des
uppmanar	upp➊ma➋nar
uppmanat	upp➊ma➋nat
uppmanats	upp➊ma➋nats
uppmärksamhet	upp➊märk➊sam➊het
uppmärksammade	upp➊märk➊sam➊ma➊de
uppmärksammades	upp➊märk➊sam➊ma➊des
upprepade	upp➊re➊pa➊de
upprepades	upp➊re➊pa➊des
Uppsala	Upp➊sala
Uppsalas	Upp➊salas
uppåt	upp➊åt
ursäkt	ur➊säkt
USA	USA
USAs	USAs
utan	ut➊an
utanför	ut➊an➊för
utbildning	ut➊bild➊ning
utbildningen	ut➊bild➊ning➊en
utbildningens	ut➊bild➊ning➊ens
utbildnings	ut➊bild➊nings
ute	ute
utföra	ut➊fö➊ra
utföras	ut➊fö➊ras
utgör	ut➊gör
utgörs	ut➊görs
utifrån	ut➊i➊från
utländsk	ut➊ländsk
utländska	ut➊länds➊ka
utnyttja	ut➊nytt➊ja
utnyttjas	ut➊nytt➊jas
utom	ut➊om
utomlands	ut➊om➊lands
utreda	ut➊re➊da
utredare	ut➊re➊da➊re
utredaren	ut➊re➊da➊ren
utredarens	ut➊re➊da➊rens
utredas	ut➊re➊das
utreder	ut➊re➊der
utredning	ut➊red➊ning
utredningar	ut➊red➊ning➊ar
utredningen	ut➊red➊ning➊en
utredningens	ut➊red➊ning➊ens
utrednings	ut➊red➊nings
utrikesdepartementet	ut➋ri➋kes➊de➋par➋te➋men➋tet
utrikesdepartementets	ut➋ri➋kes➊de➋par➋te➋men➋tets
utrikesminister	ut➋ri➋kes➊mi➋nis➋ter
utrikesministern	ut➋ri➊kes➊mi➋nis➋tern
utrikesministerns	ut➋ri➊kes➊mi➋nis➋terns
utrikesministers	ut➋ri➋kes➊mi➋nis➋ters
utrustning	ut➊rust➊ning
utrymme	ut➊rym➊me
utsatt	ut➊satt
utsatta	ut➊sat➊ta
utsattas	ut➊sat➊tas
utsatts	ut➊satts
utsläpp	ut➊släpp
utsläppen	ut➊släp➊pen
utsträckning	ut➊sträck➊ning
utsätts	ut➊sätts
uttalande	ut➊ta➊lan➊de
uttalanden	ut➊ta➊lan➊den
uttalandes	ut➊ta➊lan➊des
uttalandet	ut➊ta➊lan➊det
utveckla	ut➊veck➊la
utvecklas	ut➊veck➊las
utveckling	ut➊veck➊ling
utvecklingen	ut➊veck➊ling➊en
utvecklingens	ut➊veck➊ling➊ens
utvecklings	ut➊veck➊lings
utöver	ut➊över
vad	vad
val	val
valde	val➊de
valdes	val➊des
valet	va➊let
valets	va➊lets
valresultat	val➊re➋sul➋tat
valresultatet	val➊re➋sul➋ta➋tet
valresultatets	val➊re➋sul➋ta➋tets
valretorik	val➊re➋to➋rik
valretoriken	val➊re➋to➋ri➋ken
valrörelse	val➊rö➋rel➋se
valrörelsen	val➊rö➋rel➋sen
valrörelsens	val➊rö➋rel➋sens
vals	vals
valt	valt
valts	valts
valutafonden	va➋lu➋ta➊fon➋den
valutafondens	va➋lu➋ta➊fon➋dens
van	van
vanlig	van➊lig
vanliga	van➊li➊ga
vanligare	van➊li➊ga➊re
vanligaste	van➊li➊gas➊te
vanligt	van➊ligt
vann	vann
vanns	vanns
vapen	va➊pen
vapenvila	va➋pen➊vi➋la
var	var
vara	va➊ra
varandra	var➊and➊ra
varandras	var➊and➊ras
varas	va➊ras
varav	var➊av
vare	va➊re
varför	var➊för
varit	va➊rit
varje	var➊je
varken	var➊ken
varnade	var➊na➊de
varnades	var➊na➊des
varnar	var➊nar
varning	var➊ning
varnings	var➊nings
varor	va➊ror
varors	va➊rors
vars	vars
vart	vart
vatten	vat➊ten
Vattenfall	Vat➋ten➊fall
Vattenfalls	Vat➋ten➊falls
vattens	vat➊tens
vattnet	vatt➊net
vattnets	vatt➊nets
vecka	vecka
veckan	veck➊an
veckans	veck➊ans
veckas	veckas
veckor	veck➊or
veckorna	veck➊or➊na
veckornas	veck➊or➊nas
veckors	veck➊ors
velat	ve➊lat
vem	vem
vems	vems
Venezuela	Ve➊ne➊zue➊la
Venezuelas	Ve➊ne➊zue➊las
verkar	ver➊kar
verket	ver➊ket
verkets	ver➊kets
verkligen	verk➊li➊gen
verklighet	verk➊lig➊het
verksamhet	verk➊sam➊het
verksamheten	verk➊sam➊he➊ten
verksamhetens	verk➊sam➊he➊tens
verksamhets	verk➊sam➊hets
vet	vet
veta	ve➊ta
via	via
vice	vice
vid	vid
vidare	vi➊da➊re
viktig	vik➊tig
viktiga	vik➊ti➊ga
viktigare	vik➊ti➊ga➊re
viktigaste	vik➊ti➊gas➊te
viktigt	vik➊tigt
Viktor	Vik➊tor
Viktors	Vik➊tors
vilja	vil➊ja
vilka	vil➊ka
vilkas	vil➊kas
vilken	vil➊ken
vilket	vil➊ket
vill	vill
ville	vil➊le
villkor	vill➊kor
villkoren	vill➊ko➊ren
vinna	vin➊na
vinnas	vin➊nas
vinner	vin➊ner
vinst	vinst
vinsten	vins➊ten
vinster	vins➊ter
vintern	vin➊tern
vinterns	vin➊terns
viruset	vi➊ru➊set
virusets	vi➊ru➊sets
visa	vi➊sa
visade	vi➊sa➊de
visades	vi➊sa➊des
visar	vi➊sar
visas	vi➊sas
visat	vi➊sat
visats	vi➊sats
viss	viss
vissa	vis➊sa
visserligen	vis➊ser➊li➊gen
visst	visst
visste	viss➊te
Vita	Vi➊ta
Vitryssland	Vit➊ryss➋land
Vitrysslands	Vit➊ryss➋lands
vittnen	vitt➊nen
vittnens	vitt➊nens
Vladimir	Vla➊di➊mir
Volvo	Vol➊vo
Volvos	Vol➊vos
von	von
vore	vo➊re
vunnit	vun➊nit
vunnits	vun➊nits
vuxna	vux➊na
vuxnas	vux➊nas
vågar	vå➊gar
våld	våld
våldet	vål➊det
våldets	vål➊dets
vålds	vålds
våldsamma	våld➊sam➊ma
våldtäkt	våld➊täkt
vår	vår
våra	vå➊ra
våras	vå➊ras
vård	vård
vården	vår➊den
vårdens	vår➊dens
våren	vå➊ren
vårens	vå➊rens
vårt	vårt
väcker	väck➊er
väckt	vä➊ckt
väckts	vä➊ckts
väder	vä➊der
vädret	väd➊ret
vädrets	väd➊rets
väg	väg
vägar	vä➊gar
vägarna	vä➊gar➊na
vägarnas	vä➊gar➊nas
vägen	vä➊gen
vägens	vä➊gens
vägrar	väg➊rar
vägs	vägs
Vägverket	Väg➊ver➋ket
Vägverkets	Väg➊ver➋kets
väl	väl
väldigt	väl➊digt
välfärden	väl➊fär➊den
välfärdens	väl➊fär➊dens
välja	väl➊ja
väljare	väl➊ja➊re
väljares	väl➊ja➊res
väljarna	väl➊jar➊na
väljarnas	väl➊jar➊nas
väljas	väl➊jas
väljer	väl➊jer
välkomnar	väl➊kom➊nar
vända	vän➊da
vändas	vän➊das
vänder	vän➊der
vänner	vän➊ner
vänners	vän➊ners
Vänsterpartiet	Väns➋ter➊par➋ti➋et
Vänsterpartiets	Väns➋ter➊par➋ti➋ets
vänta	vän➊ta
väntan	vän➊tan
väntans	vän➊tans
väntar	vän➊tar
väntas	vän➊tas
väntat	vän➊tat
väntats	vän➊tats
väpnade	väp➊na➊de
värde	vär➊de
världen	värl➊den
världens	värl➊dens
världskriget	världs➊kri➋get
världskrigets	världs➊kri➋gets
Värmland	Värm➊land
Värmlands	Värm➊lands
värre	vär➊re
värst	värst
värsta	värs➊ta
väst	väst
Västbanken	Väst➊ban➋ken
Västbankens	Väst➊ban➋kens
Västerbotten	Väs➋ter➊bot➋ten
Västerbottens	Väs➋ter➊bot➋tens
västra	väst➊ra
västs	västs
växa	växa
växande	väx➊an➊de
växer	väx➊er
Wallström	Wall➊ström
Wallströms	Wall➊ströms
Washington	Wa➊shing➊ton
Washingtons	Wa➊shing➊tons
Ylva	Ylva
yngre	yng➊re
yngres	yng➊res
York	York
Yorks	Yorks
ytterligare	yt➊ter➊li➊ga➊re
ytterst	yt➊terst
Zimbabwe	Zim➊bab➊we
Zimbabwes	Zim➊bab➊wes
åka	åka
Åke	Åke
åker	åker
Åkesson	Åkes➊son
Åkessons	Åkes➊sons
åklagare	åkla➊ga➊re
åklagaren	åkla➊ga➊ren
åklagarens	åkla➊ga➊rens
åklagares	åkla➊ga➊res
åklagarna	åkla➊gar➊na
åklagarnas	åkla➊gar➊nas
åkte	åk➊te
ålder	ål➊der
ålders	ål➊ders
åren	åren
årens	årens
året	året
årets	årets
årig	årig
åriga	åri➊ga
årige	åri➊ge
åring	åring
åringen	åring➊en
åringens	åring➊ens
årings	årings
årliga	år➊li➊ga
års	års
årsskiftet	års➊skif➊tet
årsåldern	års➊ål➊dern
ÅSA	ÅSA
åsikter	åsik➊ter
åsikters	åsik➊ters
åtal	åtal
åtalade	åta➊la➊de
åtalades	åta➊la➊des
åtalas	åta➊las
åtalet	åta➊let
åtalets	åta➊lets
åtals	åtals
åter	åter
återigen	åter➊i➊gen
återstår	åter➊står
återvända	åter➊vän➊da
åtgärder	åt➊gär➊der
åtminstone	åt➊min➊sto➊ne
åtta	åt➊ta
ägare	äga➊re
ägares	äga➊res
äger	äger
äldre	äld➊re
äldres	äld➊res
ämnen	äm➊nen
ända	än➊da
ändra	änd➊ra
ändras	änd➊ras
ändrat	änd➊rat
ändrats	änd➊rats
ändå	än➊då
ännu	än➊nu
ärenden	ären➊den
ärendet	ären➊det
ärendets	ären➊dets
äta	äta
ätas	ätas
äter	äter
även	även
öka	öka
ökad	ökad
ökade	öka➊de
ökades	öka➊des
ökande	ökan➊de
ökar	ökar
ökas	ökas
ökat	ökat
ökats	ökats
ökning	ök➊ning
ökningen	ök➊ning➊en
öppen	öp➊pen
öppet	öp➊pet
öppna	öpp➊na
öppnade	öpp➊na➊de
öppnades	öpp➊na➊des
öppnar	öpp➊nar
öppnas	öpp➊nas
Örebro	Öre➊bro
Örebros	Öre➊bros
Östergötland	Ös➋ter➊göt➋land
Östergötlands	Ös➋ter➊göt➋lands
Österrike	Ös➋ter➊rike
Österrikes	Ös➋ter➊rikes
Östersjön	Ös➋ter➊sjön
Östersjöns	Ös➋ter➊sjöns
östra	öst➊ra
över	över
överallt	över➊allt
överens	över➊ens
överenskommelse	över➊ens➊kom➊mel➊se
överenskommelsen	över➊ens➊kom➊mel➊sen
överenskommelsens	över➊ens➊kom➊mel➊sens
övergrepp	över➊grepp
överhuvudtaget	över➊hu➊vud➊ta➊get
överklaga	över➊kla➊ga
överklagas	över➊kla➊gas
överlevande	över➊le➊van➊de
överlevandes	över➊le➊van➊des
överraskande	över➊ras➊kan➊de
övers	övers
översvämningar	över➊sväm➊ning➊ar
övertygad	över➊ty➊gad
överväger	över➊vä➊ger
övriga	öv➊ri➊ga
övrigas	öv➊ri➊gas
övrigt	öv➊rigt
