Form	Hyphenation

# SPDX-License-Identifier: Unicode-DFS-2016

ab‘den	ab➊‘➊den
ab‘nin	ab➊‘➊nin
ab‘ye	ab➊‘➊ye
abbas	ab➊bas
abdullah	ab➊dul➊lah
ab‘nin	ab➊‘➊nin
ab‘ye	ab➊‘➊ye
abd	abd
abd‘de	abd➊‘➊de
abd‘li	abd➊‘➊li
abd‘nin	abd➊‘➊nin
abd‘ye	abd➊‘➊ye
abd‘de	abd➊‘➊de
abd‘nin	abd➊‘➊nin
abd‘ye	abd➊‘➊ye
acı	a➊cı
acil	a➊cil
açan	a➊çan
açıdan	a➊çı➊dan
açık	a➊çık
açıkça	a➊çık➊ça
açıkladı	a➊çık➊la➊dı
açıkladığı	a➊çık➊la➊dı➊ğı
açıklama	a➊çık➊la➊ma
açıklamada	a➊çık➊la➊ma➊da
açıklamalar	a➊çık➊la➊ma➊lar
açıklamalarda	a➊çık➊la➊ma➊lar➊da
açıklamaları	a➊çık➊la➊ma➊la➊rı
açıklaması	a➊çık➊la➊ma➊sı
açıklamasında	a➊çık➊la➊ma➊sın➊da
açıklamasını	a➊çık➊la➊ma➊sı➊nı
açıklamaya	a➊çık➊la➊ma➊ya
açıklamıştı	a➊çık➊la➊mış➊tı
açıklanan	a➊çık➊la➊nan
açıklandı	a➊çık➊lan➊dı
açıklayan	a➊çık➊la➊yan
açıklık	a➊çık➊lık
açıklıyor	a➊çık➊lı➊yor
açılan	a➊çı➊lan
açıldı	a➊çıl➊dı
açılması	a➊çıl➊ma➊sı
açısından	a➊çı➊sın➊dan
açıyor	a➊çı➊yor
açlık	aç➊lık
açtı	aç➊tı
açtığı	aç➊tı➊ğı
adalet	a➊da➊let
adam	a➊dam
adamı	a➊da➊mı
adamları	a➊dam➊la➊rı
aday	a➊day
adayı	a➊da➊yı
adeta	a➊de➊ta
adı	a➊dı
adım	a➊dım
adımı	a➊dı➊mı
adımlar	a➊dım➊lar
adına	a➊dı➊na
adını	a➊dı➊nı
adil	a➊dil
adlandırılan	ad➊lan➊dı➊rı➊lan
adlı	ad➊lı
afganistan	af➊ga➊nis➊tan
afganistan‘da	af➊ga➊nis➊tan➊‘➊da
afgan	af➊gan
afganistan‘da	af➊ga➊nis➊tan➊‘➊da
afganistan‘daki	af➊ga➊nis➊tan➊‘➊da➊ki
afganistan‘ın	af➊ga➊nis➊tan➊‘➊ın
afp	afp
afrika	af➊ri➊ka
ağır	ağır
ağırlık	ağır➊lık
ağırlıklı	ağır➊lık➊lı
ağustos	ağus➊tos
ahmedinejad	ah➊me➊di➊ne➊jad
ahmet	ah➊met
aile	ai➊le
ailesi	ai➊le➊si
aids	aids
aihm	aihm
ait	ait
ajansı	a➊jan➊sı
akdeniz	ak➊de➊niz
aksi	ak➊si
aksine	ak➊si➊ne
aktif	ak➊tif
akıllı	a➊kıl➊lı
akp	akp
akpınar	ak➊pı➊nar
akşam	ak➊şam
akşamı	ak➊şa➊mı
alanlarda	a➊lan➊lar➊da
almanlar	al➊man➊lar
alma	al➊ma
almanya	al➊man➊ya
almanya‘da	al➊man➊ya➊‘➊da
almanya‘daki	al➊man➊ya➊‘➊da➊ki
almanya‘dan	al➊man➊ya➊‘➊dan
almanya‘ya	al➊man➊ya➊‘➊ya
almaya	al➊ma➊ya
almak	al➊mak
alman	al➊man
almanca	al➊man➊ca
alternatif	al➊ter➊na➊tif
alacak	ala➊cak
alarak	ala➊rak
alacağı	ala➊ca➊ğı
alan	alan
alanda	alan➊da
alanı	ala➊nı
alanında	ala➊nın➊da
aldı	al➊dı
aldığı	al➊dı➊ğı
aldığını	al➊dı➊ğı➊nı
alınacak	alı➊na➊cak
alınan	alı➊nan
alındı	alın➊dı
alındığı	alın➊dı➊ğı
alındığını	alın➊dı➊ğı➊nı
alınıyor	alı➊nı➊yor
alınması	alın➊ma➊sı
alınmasını	alın➊ma➊sı➊nı
alıyor	alı➊yor
ali	ali
allgemeine	all➊ge➊mei➊ne
almanların	al➊man➊la➊rın
almanya‘nın	al➊man➊ya➊‘➊nın
almanya‘da	al➊man➊ya➊‘➊da
almanya‘daki	al➊man➊ya➊‘➊da➊ki
almanya‘dan	al➊man➊ya‘➊dan
almanya‘nın	al➊man➊ya➊‘➊nın
almanya‘ya	al➊man➊ya➊‘➊ya
almanya‘yı	al➊man➊ya➊‘➊yı
alması	al➊ma➊sı
almayı	al➊ma➊yı
almış	al➊mış
almıştı	al➊mış➊tı
alt	alt
altı	al➊tı
altın	al➊tın
altına	al➊tı➊na
altında	al➊tın➊da
altındaki	al➊tın➊da➊ki
altını	al➊tı➊nı
ama	ama
amacı	ama➊cı
amacıyla	ama➊cıy➊la
amaçlı	amaç➊lı
amerika	ame➊ri➊ka
amerikan	ame➊ri➊kan
amerika‘nın	ame➊ri➊ka➊‘➊nın
amerikalı	ame➊ri➊ka➊lı
amerikalılar	ame➊ri➊ka➊lı➊lar
ancak	an➊cak
anda	an➊da
angela	an➊ge➊la
ankara	an➊ka➊ra
ankete	an➊ke➊te
anlamda	an➊lam➊da
annan	an➊nan
anne	an➊ne
anzeiger	an➊zei➊ger
ana	ana
anayasa	ana➊ya➊sa
anayasayı	ana➊ya➊sa➊yı
ankara‘da	an➊ka➊ra➊‘➊da
ankara‘nın	an➊ka➊ra➊‘➊nın
anlamı	an➊la➊mı
anlamına	an➊la➊mı➊na
anlaşma	an➊laş➊ma
anlaşmanın	an➊laş➊ma➊nın
anlaşması	an➊laş➊ma➊sı
anlaşmasının	an➊laş➊ma➊sı➊nın
anlaşmaya	an➊laş➊ma➊ya
anlatıyor	an➊la➊tı➊yor
anlattı	an➊lat➊tı
ara	ara
arabistan	ara➊bis➊tan
arada	ara➊da
arama	ara➊ma
araya	ara➊ya
aracı	ara➊cı
aracılığıyla	ara➊cı➊lı➊ğıy➊la
araç	araç
aradan	ara➊dan
aralarında	ara➊la➊rın➊da
aralık	ara➊lık
arap	arap
arası	ara➊sı
arasına	ara➊sı➊na
arasında	ara➊sın➊da
arasındaki	ara➊sın➊da➊ki
araştırma	araş➊tır➊ma
araştırmaya	araş➊tır➊ma➊ya
ardında	ar➊dın➊da
ardından	ar➊dın➊dan
arıyor	arı➊yor
arkasında	ar➊ka➊sın➊da
artan	ar➊tan
artık	ar➊tık
artış	ar➊tış
artıyor	ar➊tı➊yor
artması	art➊ma➊sı
arttı	art➊tı
asgari	as➊ga➊ri
askeri	as➊ke➊ri
askerin	as➊ke➊rin
asker	as➊ker
askerinin	as➊ke➊rin➊in
askerleri	as➊ker➊le➊ri
askerlerin	as➊ker➊le➊rin
askerler	as➊ker➊ler
askerlerinin	as➊ker➊ler➊in➊in
askerlerini	as➊ker➊ler➊ini
askeri	as➊ke➊ri
asya	as➊ya
asıl	asıl
askıya	as➊kı➊ya
aslında	as➊lın➊da
aşamada	aşa➊ma➊da
aşırı	aşı➊rı
aşkın	aş➊kın
atan	atan
ateş	ateş
ateşkes	ateş➊kes
atılan	atı➊lan
atina	ati➊na
atom	atom
attı	at➊tı
attığı	at➊tı➊ğı
avrupa	av➊ru➊pa
avrupa‘da	av➊ru➊pa➊‘➊da
avrupa‘daki	av➊ru➊pa➊‘➊da➊ki
avrupa‘ya	av➊ru➊pa➊‘➊ya
avrupa‘nın	av➊ru➊pa➊‘➊nın
avrupa‘da	avru➊pa➊‘➊da
avrupa‘daki	av➊ru➊pa➊‘➊da➊ki
avrupa‘nın	av➊ru➊pa➊‘➊nın
avrupa‘ya	av➊ru➊pa➊‘➊ya
avrupalı	av➊ru➊pa➊lı
avrupalılar	av➊ru➊pa➊lı➊lar
avukat	avu➊kat
avusturya	avus➊tur➊ya
avukatı	avu➊ka➊tı
avustralya	avus➊tral➊ya
ayda	ay➊da
ayı	ayı
ayında	ayın➊da
ayındaki	ayın➊da➊ki
ayından	ayın➊dan
aykırı	ay➊kı➊rı
aylarda	ay➊lar➊da
aylık	ay➊lık
aynı	ay➊nı
ayrı	ay➊rı
ayrıca	ay➊rı➊ca
ayrıntılı	ay➊rın➊tı➊lı
azaltılması	azal➊tıl➊ma➊sı
azından	azın➊dan
azınlık	azın➊lık
bakan	ba➊kan
bana	ba➊na
barack	ba➊rack
basit	ba➊sit
bavyera	bav➊ye➊ra
bazen	ba➊zen
babası	ba➊ba➊sı
bağdat	bağ➊dat
bağımsız	ba➊ğım➊sız
bağımsızlık	ba➊ğım➊sız➊lık
bağlantılı	bağ➊lan➊tı➊lı
bağlı	bağ➊lı
bakanlar	ba➊kan➊lar
bakanı	ba➊ka➊nı
bakanları	ba➊kan➊la➊rı
bakanlarının	ba➊kan➊la➊rı➊nın
bakanlığı	ba➊kan➊lı➊ğı
bakanlığı‘nın	ba➊kan➊lı➊ğı➊‘➊nın
bakanlık	ba➊kan➊lık
bakıldığında	ba➊kıl➊dı➊ğın➊da
bakımdan	ba➊kım➊dan
bakımından	ba➊kı➊mın➊dan
bakış	ba➊kış
balkan	bal➊kan
ban	ban
banka	ban➊ka
bankaların	ban➊ka➊la➊rın
bankası	ban➊ka➊sı
bankası‘nın	ban➊ka➊sı➊‘➊nın
baroso	ba➊ro➊so
barış	ba➊rış
barışçıl	ba➊rış➊çıl
barışı	ba➊rı➊şı
barışın	ba➊rı➊şın
basın	ba➊sın
basına	ba➊sı➊na
basını	ba➊sı➊nı
basınında	ba➊sı➊nın➊da
basınından	ba➊sı➊nın➊dan
basınının	ba➊sı➊nı➊nın
baskı	bas➊kı
baskısı	bas➊kı➊sı
baş	baş
başa	ba➊şa
başak	ba➊şak
başardı	ba➊şar➊dı
başarı	ba➊şa➊rı
başarılı	ba➊şa➊rı➊lı
başarısız	ba➊şa➊rı➊sız
başbakan	baş➊ba➊kan
başbakanı	baş➊ba➊ka➊nı
başbakanlık	baş➊ba➊kan➊lık
başı	ba➊şı
başına	ba➊şı➊na
başında	ba➊şın➊da
başından	ba➊şın➊dan
başka	baş➊ka
başkan	baş➊kan
başkanı	baş➊ka➊nı
başkanları	baş➊kan➊la➊rı
başkanlığı	baş➊kan➊lı➊ğı
başkanlığına	baş➊kan➊lı➊ğı➊na
başkanlığını	baş➊kan➊lı➊ğı➊nı
başkanlık	baş➊kan➊lık
başkent	baş➊kent
başkenti	baş➊ken➊ti
başladı	baş➊la➊dı
başladığı	baş➊la➊dı➊ğı
başladığını	baş➊la➊dı➊ğı➊nı
başlaması	baş➊la➊ma➊sı
başlandı	baş➊lan➊dı
başlangıç	baş➊lan➊gıç
başlatılan	baş➊la➊tı➊lan
başlattı	baş➊lat➊tı
başlattığı	baş➊lat➊tı➊ğı
başlayacak	baş➊la➊ya➊cak
başlayan	baş➊la➊yan
başlıca	baş➊lı➊ca
başlıklı	başlık➊lı
başlıyor	baş➊lı➊yor
başta	baş➊ta
başvuru	baş➊vu➊ru
batı	ba➊tı
batılı	ba➊tı➊lı
bayern	ba➊yern
bazı	ba➊zı
bazıları	ba➊zı➊la➊rı
beklan	bek➊lan
beklenen	bek➊le➊nen
bekleniyor	bek➊le➊ni➊yor
bekleyen	bek➊le➊yen
bekliyor	bek➊li➊yor
belediye	be➊le➊di➊ye
belirleyici	be➊lir➊le➊yi➊ci
belirli	be➊lir➊li
belirsiz	be➊lir➊siz
belirterek	be➊lir➊te➊rek
belirten	be➊lir➊ten
belirtilen	be➊lir➊ti➊len
belirtiliyor	be➊lir➊ti➊li➊yor
belirtildi	be➊lir➊til➊di
belirtiyor	be➊lir➊ti➊yor
belirtti	be➊lirt➊ti
beni	be➊ni
benim	be➊nim
beraberinde	be➊ra➊be➊rin➊de
beri	be➊ri
belki	bel➊ki
belli	bel➊li
belçika	bel➊çi➊ka
ben	ben
benzeri	ben➊ze➊ri
benzer	ben➊zer
berliner	ber➊li➊ner
berlin	ber➊lin
berlin‘de	ber➊lin➊‘➊de
berlusconi	ber➊lus➊co➊ni
berlin‘de	ber➊lin➊‘➊de
berlin‘deki	ber➊lin➊‘➊de➊ki
beş	beş
beşar	be➊şar
beyaz	be➊yaz
bırakılması	bı➊ra➊kıl➊ma➊sı
bıraktı	bı➊rak➊tı
bile	bi➊le
bilinen	bi➊li➊nen
biliniyor	bi➊li➊ni➊yor
bilim	bi➊lim
bilimsel	bi➊lim➊sel
bilinmiyor	bi➊lin➊mi➊yor
biliyor	bi➊li➊yor
bine	bi➊ne
bini	bi➊ni
biraraya	bi➊ra➊ra➊ya
biraz	bi➊raz
biri	bi➊ri
birimi	bi➊ri➊mi
birini	bi➊ri➊ni
birinin	bi➊ri➊nin
birimleri	bi➊rim➊le➊ri
birimlerinin	bi➊rim➊le➊ri➊nin
birinci	bi➊rin➊ci
bize	bi➊ze
bizi	bi➊zi
bizim	bi➊zim
biçimde	bi➊çim➊de
bildiriliyor	bil➊di➊ri➊li➊yor
bildirildi	bil➊di➊ril➊di
bildirdi	bil➊dir➊di
bilgi	bil➊gi
bilgilere	bil➊gi➊le➊re
bilgileri	bil➊gi➊le➊ri
bilgilerin	bil➊gi➊le➊rin
bilgiler	bil➊gi➊ler
bilgisayar	bil➊gi➊sa➊yar
bilgiye	bil➊gi➊ye
bild	bild
bilişim	bi➊li➊şim
bin	bin
binden	bin➊den
binlerce	bin➊ler➊ce
bir	bir
birbirine	bir➊bi➊ri➊ne
birbirinden	bir➊bi➊rin➊den
birkaç	bir➊kaç
birlikleri	bir➊lik➊le➊ri
birliklerin	bir➊lik➊le➊rin
birliklerinin	bir➊lik➊le➊ri➊nin
birlik	bir➊lik
birlikte	bir➊lik➊te
birçok	bir➊çok
birleşik	bir➊le➊şik
birleşmiş	bir➊leş➊miş
birliği	bir➊li➊ği
birliği‘nin	bir➊li➊ği➊‘➊nin
birliği‘ne	bir➊li➊ği➊‘➊ne
birliği‘nin	bir➊li➊ği➊‘➊nin
birliğin	bir➊li➊ğin
biz	biz
bizzat	biz➊zat
blair	blair
bm‘nin	bm➊‘➊nin
borussia	bo➊rus➊sia
bomba	bom➊ba
bombalı	bom➊ba➊lı
borç	borç
boru	bo➊ru
bosna	bos➊na
boş	boş
boykot	boy➊kot
boyu	bo➊yu
boyunca	bo➊yun➊ca
bölümü	bö➊lü➊mü
bölge	böl➊ge
bölgede	böl➊ge➊de
bölgedeki	böl➊ge➊de➊ki
bölgelerinde	böl➊ge➊le➊rin➊de
bölgesel	böl➊ge➊sel
bölgesi	böl➊ge➊si
bölgesinde	böl➊ge➊sin➊de
bölgesindeki	böl➊ge➊sin➊de➊ki
bölgelerde	böl➊ge➊ler➊de
bölgenin	böl➊ge➊nin
bölgeye	böl➊ge➊ye
böyle	böy➊le
böylece	böy➊le➊ce
brezilya	bre➊zil➊ya
brown	brown
brüksel	brük➊sel
brüksel‘de	brük➊sel➊‘➊de
brüksel‘de	brük➊sel➊‘➊de
bugüne	bu➊gü➊ne
bugün	bu➊gün
bugünkü	bu➊gün➊kü
bulan	bu➊lan
bulunarak	bu➊lu➊na➊rak
bulunan	bu➊lu➊nan
bulunuyor	bu➊lu➊nu➊yor
bulundu	bu➊lun➊du
bulunmak	bu➊lun➊mak
bulunmuyor	bu➊lun➊mu➊yor
buluyor	bu➊lu➊yor
buna	bu➊na
bunu	bu➊nu
bunun	bu➊nun
bununla	bu➊nun➊la
burada	bu➊ra➊da
buradaki	bu➊ra➊da➊ki
buldu	bul➊du
bulgaristan	bul➊ga➊ris➊tan
bulmak	bul➊mak
bulunduğu	bu➊lun➊du➊ğu
bulunduğunu	bu➊lun➊du➊ğu➊nu
bulunmadığını	bu➊lun➊ma➊dı➊ğı➊nı
bulunması	bu➊lun➊ma➊sı
bulunmuştu	bu➊lun➊muş➊tu
bundan	bun➊dan
bunlar	bun➊lar
bunları	bun➊la➊rı
bunların	bun➊la➊rın
bush	bush
bush‘un	bush➊‘➊un
bünyesinde	bün➊ye➊sin➊de
bütçe	büt➊çe
bütün	bü➊tün
büyükelçisi	bü➊yük➊el➊çi➊si
büyüme	bü➊yü➊me
büyük	bü➊yük
büyüyor	bü➊yü➊yor
casusluk	ca➊sus➊luk
can	can
canlı	can➊lı
cdu	cdu
cenevre	ce➊nev➊re
cesaret	ce➊sa➊ret
cevap	ce➊vap
ceza	ce➊za
cep	cep
cezası	ce➊za➊sı
cezasına	ce➊za➊sı➊na
chirac	chi➊rac
chp	chp
christian	chris➊ti➊an
cia	cia
ciddi	cid➊di
ciddiye	cid➊di➊ye
cinsel	cin➊sel
cinayet	ci➊na➊yet
civarında	ci➊va➊rın➊da
clinton	clin➊ton
condoleezza	con➊do➊leez➊za
csu	csu
cuma	cu➊ma
cumartesi	cu➊mar➊te➊si
cumhuriyeti	cum➊hu➊ri➊ye➊ti
cumhuriyet	cum➊hu➊ri➊yet
cumhuriyetçi	cum➊hu➊ri➊yet➊çi
cumhurbaşkanı	cum➊hur➊baş➊ka➊nı
cumhurbaşkanlığı	cum➊hur➊baş➊kan➊lı➊ğı
çaba	ça➊ba
çabaları	ça➊ba➊la➊rı
çağırdı	ça➊ğır➊dı
çağrı	çağ➊rı
çağrıda	çağ➊rı➊da
çağrısı	çağ➊rı➊sı
çağrısında	çağ➊rı➊sın➊da
çalışan	ça➊lı➊şan
çalışıyor	ça➊lı➊şı➊yor
çalışma	ça➊lış➊ma
çalışmak	ça➊lış➊mak
çalışmalar	ça➊lış➊ma➊lar
çalışmaları	ça➊lış➊ma➊la➊rı
çalışmalarına	ça➊lış➊ma➊la➊rı➊na
çalışmalarını	ça➊lışma➊la➊rı➊nı
çalıştı	ça➊lış➊tı
çalıştığı	ça➊lış➊tı➊ğı
çapında	ça➊pın➊da
çarpıyor	çar➊pı➊yor
çarşamba	çar➊şam➊ba
çatışma	ça➊tış➊ma
çatışmalar	ça➊tış➊ma➊lar
çatışmalarda	ça➊tış➊ma➊lar➊da
çatışmaların	ça➊tış➊ma➊la➊rın
çavuşoğlu	ça➊vuş➊oğ➊lu
çekerek	çe➊ke➊rek
çeken	çe➊ken
çekiliyor	çe➊ki➊li➊yor
çekildi	çe➊kil➊di
çekilme	çe➊kil➊me
çekilmesi	çe➊kil➊me➊si
çekiyor	çe➊ki➊yor
çelik	çe➊lik
çelikkafa	çe➊lik➊ka➊fa
çeviri	çe➊vi➊ri
çevirdi	çe➊vir➊di
çevre	çev➊re
çek	çek
çekti	çek➊ti
çerçevede	çer➊çe➊ve➊de
çerçevesinde	çer➊çe➊ve➊sin➊de
çeşitli	çe➊şit➊li
çeyrek	çey➊rek
çıkılacak	çı➊kı➊la➊cak
çıkan	çı➊kan
çıkar	çı➊kar
çıkardı	çı➊kar➊dı
çıkarları	çı➊kar➊la➊rı
çıkış	çı➊kış
çıkıyor	çı➊kı➊yor
çıkması	çık➊ma➊sı
çıkmıştı	çık➊mış➊tı
çıktı	çık➊tı
çıktığı	çık➊tı➊ğı
çıktığını	çık➊tı➊ğı➊nı
çifte	çif➊te
çin	çin
çin‘in	çin➊‘➊in
çinli	çin➊li
çin‘de	çin➊‘➊de
çin‘in	çin➊‘➊in
çizdi	çiz➊di
çocuklara	ço➊cuk➊la➊ra
çocuklar	ço➊cuk➊lar
çocuk	ço➊cuk
çocuğun	ço➊cu➊ğun
çocukları	ço➊cuk➊la➊rı
çocukların	ço➊cuk➊la➊rın
çoğu	ço➊ğu
çoğunluğu	ço➊ğun➊lu➊ğu
çoğunluk	ço➊ğun➊luk
çoğunlukla	ço➊ğun➊luk➊la
çok	çok
çoktan	çok➊tan
çözüme	çö➊zü➊me
çözümü	çö➊zü➊mü
çözüm	çö➊züm
çünkü	çün➊kü
daha	da➊ha
dahi	da➊hi
dahil	da➊hil
david	da➊vid
dahil	da➊hil
daimi	da➊i➊mi
dairesi	da➊i➊re➊si
dair	da➊ir
dakika	da➊ki➊ka
dakikada	da➊ki➊ka➊da
damgasını	dam➊ga➊sı➊nı
dan	dan
danışmanı	da➊nış➊ma➊nı
danimarka	da➊ni➊mar➊ka
darbe	dar➊be
dava	da➊va
davada	da➊va➊da
davanın	da➊va➊nın
davası	da➊va➊sı
davet	da➊vet
davutoğlu	da➊vut➊oğ➊lu
dayanışma	da➊ya➊nış➊ma
dedi	de➊di
demetçe	de➊met➊çe
demek	de➊mek
demokrasi	de➊mok➊ra➊si
demokrasinin	de➊mok➊ra➊si➊nin
demokratik	de➊mok➊ra➊tik
demokrat	de➊mok➊rat
demokratlar	de➊mok➊rat➊lar
denetim	de➊ne➊tim
denildi	de➊nil➊di
deniz	de➊niz
depremin	dep➊re➊min
deprem	dep➊rem
derece	de➊re➊ce
derin	de➊rin
değer	de➊ğer
değerlendirdi	de➊ğer➊len➊dir➊di
değerlendiren	de➊ğer➊len➊di➊ren
değerlendiriliyor	de➊ğer➊len➊di➊ri➊li➊yor
değerlendiriyor	de➊ğer➊len➊di➊ri➊yor
değil	de➊ğil
değildi	de➊ğil➊di
değildir	de➊ğil➊dir
değiniyor	de➊ği➊ni➊yor
değişikliği	de➊ği➊şik➊li➊ği
değişiklik	de➊ği➊şik➊lik
değişiklikler	de➊ği➊şik➊lik➊ler
değişim	de➊ği➊şim
dek	dek
demokratların	de➊mok➊rat➊la➊rın
den	den
der	der
dergisi	der➊gi➊si
derleyen	der➊le➊yen
derhal	der➊hal
ders	ders
destek	des➊tek
desteği	des➊te➊ği
desteğini	des➊te➊ği➊ni
deutsche	deu➊tsche
dev	dev
devleti	dev➊le➊ti
devletinin	dev➊le➊ti➊nin
devletin	dev➊le➊tin
devlet	dev➊let
devletleri	dev➊let➊le➊ri
devletler	dev➊let➊ler
devam	de➊vam
devi	de➊vi
devreye	dev➊re➊ye
devrim	dev➊rim
dış	dış
dışı	dı➊şı
dışına	dı➊şı➊na
dışında	dı➊şın➊da
dışındaki	dı➊şın➊da➊ki
dışişleri	dış➊iş➊le➊ri
dijital	di➊ji➊tal
dile	di➊le
dini	di➊ni
diplomatik	dip➊lo➊ma➊tik
dizi	di➊zi
die	die
diğer	di➊ğer
dikkate	dik➊ka➊te
dikkat	dik➊kat
dikkatli	dik➊kat➊li
dil	dil
dille	dil➊le
din	din
dinci	din➊ci
diyalog	di➊ya➊log
diye	di➊ye
diyerek	di➊ye➊rek
diyen	di➊yen
diyor	di➊yor
dokuz	do➊kuz
dolara	do➊la➊ra
dolar	do➊lar
dolu	do➊lu
domuz	do➊muz
donald	do➊nald
doğal	do➊ğal
doğalgaz	do➊ğal➊gaz
doğan	do➊ğan
doğru	doğ➊ru
doğrudan	doğ➊ru➊dan
doğrultusunda	doğ➊rul➊tu➊sun➊da
doğu	do➊ğu
doğum	do➊ğum
doğusunda	do➊ğu➊sun➊da
doğusundaki	do➊ğu➊sun➊da➊ki
dolarlık	do➊lar➊lık
dolayı	do➊la➊yı
dolayında	do➊la➊yın➊da
dolayısıyla	do➊la➊yı➊sıy➊la
dortmund	dort➊mund
dönemi	dö➊ne➊mi
dönemin	dö➊ne➊min
döneminde	dö➊ne➊min➊de
dönem	dö➊nem
dönemde	dö➊nem➊de
döndü	dön➊dü
dördüncü	dör➊dün➊cü
dört	dört
dpa	dpa
duruma	du➊ru➊ma
durumu	du➊ru➊mu
durumuna	du➊ru➊mu➊na
durumunu	du➊ru➊mu➊nu
durumunun	du➊ru➊mu➊nun
durumun	du➊ru➊mun
durumunda	du➊ru➊mun➊da
durum	du➊rum
durumda	du➊rum➊da
duyduğu	duy➊du➊ğu
duyduğunu	duy➊du➊ğu➊nu
duyulan	du➊yu➊lan
duyurdu	du➊yur➊du
duyurmuştu	du➊yur➊muş➊tu
düzenledi	dü➊zen➊le➊di
düzenleme	dü➊zen➊le➊me
düzenlenen	dü➊zen➊le➊nen
düzenlendi	dü➊zen➊len➊di
düzenlenecek	dü➊zen➊le➊ne➊cek
düzenleyen	dü➊zen➊le➊yen
düzenli	dü➊zen➊li
düzey	dü➊zey
düzeyde	dü➊zey➊de
dün	dün
dünya	dün➊ya
dünyada	dün➊ya➊da
dünyadaki	dün➊ya➊da➊ki
dünyaya	dün➊ya➊ya
dünyanın	dün➊ya➊nın
dünyası	dün➊ya➊sı
dünyasında	dün➊ya➊sın➊da
dınyasının	dın➊ya➊sı➊nın
dünyayı	dün➊ya➊yı
düşen	dü➊şen
düşman	düş➊man
düşmanı	düş➊ma➊nı
düştü	düş➊tü
düşük	dü➊şük
düşünce	dü➊şün➊ce
düşünüyor	dü➊şü➊nü➊yor
düşünüyorum	dü➊şü➊nü➊yo➊rum
düşüş	dü➊şüş
düşüyor	dü➊şü➊yor
düzenlediği	dü➊zen➊le➊di➊ği
dw‘den	dw➊‘➊den
ebu	ebu
edecek	ede➊cek
ederek	ede➊rek
edeceği	ede➊ce➊ği
edeceğini	ede➊ce➊ği➊ni
eden	eden
ederken	eder➊ken
edici	edi➊ci
edilecek	edi➊le➊cek
edilemez	edi➊le➊mez
edilen	edi➊len
ediliyor	edi➊li➊yor
edildi	edil➊di
edilmesi	edil➊me➊si
edilmesine	edil➊me➊si➊ne
edilmesini	edil➊me➊si➊ni
edilmesinin	edil➊me➊si➊nin
edildiği	edil➊di➊ği
edildiğini	edil➊di➊ği➊ni
edilmiş	edil➊miş
edilmişti	edil➊miş➊ti
edip	edip
editör	edi➊tör
ediyor	edi➊yor
ediyorlar	edi➊yor➊lar
ediyoruz	edi➊yo➊ruz
eğer	eğer
eğitim	eği➊tim
eğitimi	eği➊ti➊mi
ehud	ehud
ekledi	ek➊le➊di
ekibi	eki➊bi
ekim	ekim
ekliyor	ek➊li➊yor
ekonomi	eko➊no➊mi
ekonominin	eko➊no➊mi➊nin
ekonomisi	eko➊no➊mi➊si
ekonomisinin	eko➊no➊mi➊si➊nin
ekonomik	eko➊no➊mik
elbette	el➊bet➊te
elde	el➊de
ele	ele
elektrik	elekt➊rik
elektronik	elekt➊ro➊nik
eleştirdi	eleş➊tir➊di
eleştirel	eleş➊ti➊rel
eleştiren	eleş➊ti➊ren
eleştiri	eleş➊ti➊ri
eleştiriler	eleş➊ti➊ri➊ler
eleştirilere	eleş➊ti➊ri➊le➊re
eleştiriyor	eleş➊ti➊ri➊yor
eline	eli➊ne
elinde	elin➊de
elinden	elin➊den
emniyet	em➊ni➊yet
emekli	emek➊li
emeklilik	emek➊li➊lik
emin	emin
engel	en➊gel
engellemek	en➊gel➊le➊mek
endişe	en➊di➊şe
endişeli	en➊di➊şe➊li
endişesi	en➊di➊şe➊si
enerji	ener➊ji
enerjisi	ener➊ji➊si
enstitüsü	ens➊ti➊tü➊sü
erdi	er➊di
erkek	er➊kek
erken	er➊ken
ermeni	er➊me➊ni
ermenistan	er➊me➊nis➊tan
erdoğan	er➊do➊ğan
erdoğan‘ın	er➊do➊ğan➊‘➊ın
erdoğan‘ın	er➊do➊ğan➊‘➊ın
esad	esad
eski	es➊ki
eşi	eşi
eşit	eşit
etki	et➊ki
etkileri	et➊ki➊le➊ri
etkili	et➊ki➊li
etkisi	et➊ki➊si
etkisini	et➊ki➊si➊ni
etkin	et➊kin
etme	et➊me
etmesi	et➊me➊si
etmesine	et➊me➊si➊ne
etmesini	et➊me➊si➊ni
etmek	et➊mek
etmeye	et➊me➊ye
etmeyi	et➊me➊yi
etmiyor	et➊mi➊yor
etnik	et➊nik
etti	et➊ti
ettikleri	et➊tik➊le➊ri
ettiklerini	et➊tik➊le➊ri➊ni
ettiler	et➊ti➊ler
etmiş	et➊miş
etmişti	et➊miş➊ti
ettiği	et➊ti➊ği
ettiğini	et➊ti➊ği➊ni
euro	eu➊ro
euroluk	eu➊ro➊luk
euroya	eu➊ro➊ya
evet	evet
eylemi	ey➊le➊mi
eylem	ey➊lem
eylemleri	ey➊lem➊le➊ri
eylül	ey➊lül
eyaletinde	eya➊le➊tin➊de
eyaleti	eya➊le➊ti
eyalet	eya➊let
fakat	fa➊kat
faaliyet	fa➊a➊li➊yet
faaliyetleri	fa➊a➊li➊yet➊le➊ri
faaliyetlerini	fa➊a➊li➊yet➊le➊ri➊ni
facebook	face➊book
faiz	fa➊iz
fark	fark
farklı	fark➊lı
fazla	faz➊la
federal	fe➊de➊ral
felaket	fe➊la➊ket
fetih	fe➊tih
fırsat	fır➊sat
fifa	fi➊fa
fikir	fi➊kir
filistin	fi➊lis➊tin
filistinli	fi➊lis➊tin➊li
filistinliler	fi➊lis➊tin➊li➊ler
final	fi➊nal
finans	fi➊nans
fischer	fi➊scher
filmi	fil➊mi
film	film
fiyat	fi➊yat
fiyatları	fi➊yat➊la➊rı
fonu	fo➊nu
fransa	fran➊sa
fransa‘da	fran➊sa➊‘➊da
françois	fran➊çois
frank	frank
frankfurter	frank➊fur➊ter
frankfurt	frank➊furt
fransa‘nın	fran➊sa➊‘➊nın
fransa‘da	fran➊sa➊‘➊da
fransa‘nın	fran➊sa➊‘➊nın
fransız	fran➊sız
futbol	fut➊bol
füze	fü➊ze
gabriel	gab➊ri➊el
garanti	ga➊ran➊ti
gazete	ga➊ze➊te
gazeteci	ga➊ze➊te➊ci
gazetecilere	ga➊ze➊te➊ci➊le➊re
gazetecilerin	ga➊ze➊te➊ci➊le➊rin
gazeteciler	ga➊ze➊te➊ci➊ler
gazetelerinin	ga➊ze➊te➊le➊ri➊nin
gazetelerinde	ga➊ze➊te➊le➊rin➊de
gazetelerinden	ga➊ze➊te➊le➊rin➊den
gazetesi	ga➊ze➊te➊si
gazetesine	ga➊ze➊te➊si➊ne
gazetesinin	ga➊ze➊te➊si➊nin
gazetesinde	ga➊ze➊te➊sin➊de
gazetenin	ga➊ze➊te➊nin
gauck	gauck
gayet	ga➊yet
gaz	gaz
gazze	gaz➊ze
gazı	ga➊zı
gece	ge➊ce
gelecek	ge➊le➊cek
gelecekte	ge➊le➊cek➊te
geleneksel	ge➊le➊nek➊sel
gelen	ge➊len
gelir	ge➊lir
geliyor	ge➊li➊yor
genelinde	ge➊ne➊lin➊de
general	ge➊ne➊ral
genel	ge➊nel
genelde	ge➊nel➊de
genelkurmay	ge➊nel➊kur➊may
george	ge➊or➊ge
gereken	ge➊re➊ken
gerekir	ge➊re➊kir
gerekiyor	ge➊re➊ki➊yor
gerekli	ge➊rek➊li
gerek	ge➊rek
gerekse	ge➊rek➊se
gerekçe	ge➊rek➊çe
gerekçesiyle	ge➊rek➊çe➊siy➊le
geri	ge➊ri
geride	ge➊ri➊de
gerilim	ge➊ri➊lim
geriye	ge➊ri➊ye
getiren	ge➊ti➊ren
getirilen	ge➊ti➊ri➊len
getirildi	ge➊ti➊ril➊di
getirilmesi	ge➊ti➊ril➊me➊si
getiriyor	ge➊ti➊ri➊yor
getirdi	ge➊tir➊di
getirmesi	ge➊tir➊me➊si
getirmek	ge➊tir➊mek
geç	geç
geçmesi	geç➊me➊si
geçmek	geç➊mek
geçen	ge➊çen
geçerli	ge➊çer➊li
geçici	ge➊çi➊ci
geçirilmesi	ge➊çi➊ril➊mesi
geçirdi	ge➊çir➊di
geçirdiği	ge➊çir➊di➊ği
geçiş	ge➊çiş
geçiyor	ge➊çi➊yor
geçmiş	geç➊miş
geçmişte	geç➊miş➊te
geçti	geç➊ti
geçtiği	geç➊ti➊ği
geçtiğimiz	geç➊ti➊ği➊miz
geldi	gel➊di
gelmesi	gel➊me➊si
gelmiyor	gel➊mi➊yor
geldiği	gel➊di➊ği
geldiğini	gel➊di➊ği➊ni
geleceği	ge➊le➊ce➊ği
geleceğini	ge➊le➊ce➊ği➊ni
gelişme	ge➊liş➊me
gelişmekte	ge➊liş➊mek➊te
gelişmeler	ge➊liş➊me➊ler
gelişmelere	ge➊liş➊me➊le➊re
gelişmeleri	ge➊liş➊me➊le➊ri
gelişmelerin	ge➊liş➊me➊le➊rin
gelişmiş	ge➊liş➊miş
gelmiş	gel➊miş
gelmişti	gel➊miş➊ti
genç	genç
gençlerin	genç➊le➊rin
gençler	genç➊ler
gençlik	genç➊lik
geniş	ge➊niş
genişleme	ge➊niş➊le➊me
gerginlik	ger➊gin➊lik
gerhard	ger➊hard
gerçeği	ger➊çe➊ği
gerçek	ger➊çek
gerçekten	ger➊çek➊ten
gerektiği	ge➊rek➊ti➊ği
gerektiğine	ge➊rek➊ti➊ği➊ne
gerektiğini	ge➊rek➊ti➊ği➊ni
gerginliği	ger➊gin➊li➊ği
getirdiği	ge➊tir➊di➊ği
gıda	gı➊da
gibi	gi➊bi
gidecek	gi➊de➊cek
giderek	gi➊de➊rek
giden	gi➊den
gidiyor	gi➊di➊yor
giren	gi➊ren
girdi	gir➊di
girmesi	gir➊me➊si
giriş	gi➊riş
girişim	gi➊ri➊şim
girişimi	gi➊ri➊şi➊mi
girişiminin	gi➊ri➊şi➊mi➊nin
gitmek	git➊mek
gitti	git➊ti
gittikçe	git➊tik➊çe
gizli	giz➊li
google	goo➊gle
göre	gö➊re
göreve	gö➊re➊ve
görevi	gö➊re➊vi
görevine	gö➊re➊vi➊ne
görevini	gö➊re➊vi➊ni
görevinden	gö➊re➊vin➊den
gören	gö➊ren
görev	gö➊rev
görevden	gö➊rev➊den
görevli	gö➊rev➊li
göç	göç
göçmen	göç➊men
göçmenlere	göç➊men➊le➊re
göçmenlerin	göç➊men➊le➊rin
göçmenler	göç➊men➊ler
gönderilen	gön➊de➊ri➊len
gördü	gör➊dü
görmek	gör➊mek
gördüğü	gör➊dü➊ğü
görülen	gö➊rü➊len
görülüyor	gö➊rü➊lü➊yor
görüldü	gö➊rül➊dü
görünüyor	gö➊rü➊nü➊yor
görüş	gö➊rüş
görüşlere	gö➊rüş➊le➊re
görüşleri	gö➊rüş➊le➊ri
görüşlerini	gö➊rüş➊le➊ri➊ni
görüşme	gö➊rüş➊me
görüşmede	gö➊rüş➊me➊de
görüşmek	gö➊rüş➊mek
görüşmeler	gö➊rüş➊me➊ler
görüşmelerde	gö➊rüş➊me➊ler➊de
görüşmelere	gö➊rüş➊me➊le➊re
görüşmeleri	gö➊rüş➊me➊le➊ri
görüşmelerin	gö➊rüş➊me➊le➊rin
görüşmelerinin	gö➊rüş➊me➊le➊ri➊nin
görüşmenin	gö➊rüş➊me➊nin
görüşmesi	gö➊rüş➊me➊si
görüştü	gö➊rüş➊tü
görüşü	gö➊rü➊şü
görüşünde	gö➊rü➊şün➊de
görüşünü	gö➊rü➊şü➊nü
görüyor	gö➊rü➊yor
gösteren	gös➊te➊ren
gösteri	gös➊te➊ri
göstericiler	gös➊te➊ri➊ci➊ler
gösterileri	gös➊te➊ri➊le➊ri
gösterilen	gös➊te➊ri➊len
gösteriler	gös➊te➊ri➊ler
gösteriyor	gös➊te➊ri➊yor
gösterdi	gös➊ter➊di
göstergesi	gös➊ter➊ge➊si
göstermesi	gös➊ter➊me➊si
göstermek	gös➊ter➊mek
gösterdiği	gös➊ter➊di➊ği
göz	göz
gözden	göz➊den
gözlemciler	göz➊lem➊ci➊ler
gözler	göz➊ler
gözaltına	göz➊al➊tı➊na
göze	gö➊ze
grev	grev
gribi	gri➊bi
grubu	gru➊bu
grubun	gru➊bun
gruplar	grup➊lar
grup	grup
grupları	grup➊la➊rı
grupların	grup➊la➊rın
guatanamo	gua➊ta➊na➊mo
gülen	gü➊len
güney	gü➊ney
güneyinde	gü➊ne➊yin➊de
güneyindeki	gü➊ne➊yin➊de➊ki
günü	gü➊nü
güvenilir	gü➊ve➊ni➊lir
güven	gü➊ven
güvenli	gü➊ven➊li
güvenlik	gü➊ven➊lik
güvence	gü➊ven➊ce
güzel	gü➊zel
gücü	gü➊cü
gücünü	gü➊cü➊nü
gücünün	gü➊cü➊nün
güç	güç
güçleri	güç➊le➊ri
güçlerin	güç➊le➊rin
güçler	güç➊ler
güçlerinin	güç➊le➊ri➊nin
güçlü	güç➊lü
gül	gül
gümrük	güm➊rük
gün	gün
günde	gün➊de
gündeme	gün➊de➊me
gündeminde	gün➊de➊min➊de
gündem	gün➊dem
gündemde	gün➊dem➊de
günler	gün➊ler
günlük	gün➊lük
günaltay	gü➊nal➊tay
güneş	gü➊neş
günlerde	gün➊ler➊de
günümüzde	gü➊nü➊müz➊de
gününde	gü➊nün➊de
gürcistan	gür➊cis➊tan
güvenliği	gü➊ven➊li➊ği
habere	ha➊be➊re
haberi	ha➊be➊ri
haberine	ha➊be➊ri➊ne
haber	ha➊ber
haberde	ha➊ber➊de
haberlere	ha➊ber➊le➊re
haberleri	ha➊ber➊le➊ri
haberler	ha➊ber➊ler
haberinde	ha➊be➊rin➊de
hakaret	ha➊ka➊ret
hakim	ha➊kim
hala	ha➊la
hale	ha➊le
halen	ha➊len
haline	ha➊li➊ne
halinde	ha➊lin➊de
hamas	ha➊mas
hapis	ha➊pis
harekete	ha➊re➊ke➊te
hareketi	ha➊re➊ke➊ti
hareket	ha➊re➊ket
hata	ha➊ta
hava	ha➊va
hayata	ha➊ya➊ta
hayal	ha➊yal
hayat	ha➊yat
hayatta	ha➊yat➊ta
haziran	ha➊zi➊ran
hafta	haf➊ta
haftalarda	haf➊ta➊lar➊da
haftalık	haf➊ta➊lık
hak	hak
hakim	ha➊kim
hakkı	hak➊kı
hakkına	hak➊kı➊na
hakkında	hak➊kın➊da
hakkındaki	hak➊kın➊da➊ki
hakkını	hak➊kı➊nı
hakları	hak➊la➊rı
haklarını	hak➊la➊rı➊nı
haklarının	hak➊la➊rı➊nın
haklı	hak➊lı
hal	hal
halde	hal➊de
halka	hal➊ka
hala	ha➊la
halk	halk
halkı	hal➊kı
halkın	hal➊kın
halkına	hal➊kı➊na
halkının	hal➊kı➊nın
ham	ham
hamburg	ham➊burg
hamas‘ın	hamas➊‘➊ın
hangi	han➊gi
hannover	han➊no➊ver
hans	hans
hassas	has➊sas
hatta	hat➊ta
hattı	hat➊tı
hayli	hay➊li
hayatı	ha➊ya➊tı
hayatını	ha➊ya➊tı➊nı
hayır	ha➊yır
hazzır	haz➊zır
hazırladığı	ha➊zır➊la➊dı➊ğı
hazırlanan	ha➊zır➊la➊nan
hazırlanıyor	ha➊zır➊la➊nı➊yor
hazırlık	ha➊zır➊lık
hdp	hdp
hedefleri	he➊def➊le➊ri
hadefliyor	ha➊def➊li➊yor
hedefi	he➊de➊fi
hedefleniyor	he➊def➊le➊ni➊yor
hedef	he➊def
hemen	he➊men
hem	hem
henüz	he➊nüz
hep	hep
hepsi	hep➊si
her	her
herhangi	her➊han➊gi
herkesin	her➊ke➊sin
herkes	her➊kes
hesap	he➊sap
hıristiyan	hı➊ris➊ti➊yan
hız	hız
hızla	hız➊la
hızlı	hız➊lı
hiç	hiç
hiçbir	hiç➊bir
hillary	hi➊lla➊ry
hindistan	hin➊dis➊tan
hizbullah	hiz➊bul➊lah
hizmet	hiz➊met
hollande	hol➊lan➊de
hollanda	hol➊lan➊da
horst	horst
hrıstiyan	hrıs➊ti➊yan
hristiyan	hris➊ti➊yan
hukuki	hu➊ku➊ki
hukuk	hu➊kuk
hükümete	hü➊kü➊me➊te
hükümeti	hü➊kü➊me➊ti
hükümetine	hü➊kü➊me➊ti➊ne
hükümetini	hü➊kü➊me➊ti➊ni
hükümetinin	hü➊kü➊me➊ti➊nin
hükümetin	hü➊kü➊me➊tin
hükümet	hü➊kü➊met
hülya	hül➊ya
hüseyin	hü➊se➊yin
hür	hür
ılımlı	ılım➊lı
ırkçı	ırk➊çı
ısrar	ıs➊rar
ışığında	ışı➊ğın➊da
ışık	ışık
iade	ia➊de
içeren	içe➊ren
içerisinde	içe➊ri➊sin➊de
içi	içi
içine	içi➊ne
için	için
içinde	için➊de
içindeki	için➊de➊ki
içişleri	iç➊iş➊le➊ri
iddialar	id➊dia➊lar
iddia	id➊dia
idam	idam
iddiaları	id➊dia➊la➊rı
iddiası	id➊dia➊sı
ifade	ifa➊de
ifadesini	ifa➊de➊si➊ni
ifadelerini	ifa➊de➊le➊ri➊ni
ihtimali	ih➊ti➊ma➊li
ihtimal	ih➊ti➊mal
ihtiyaç	ih➊ti➊yaç
ihlal	ih➊lal
ihracat	ih➊ra➊cat
ihraç	ih➊raç
ihtiyacı	ih➊ti➊ya➊cı
ikna	ik➊na
iktidar	ik➊ti➊dar
iktidarda	ik➊ti➊dar➊da
iktidardaki	ik➊ti➊dar➊da➊ki
iktidara	ik➊ti➊da➊ra
iki	iki
ikili	iki➊li
ikisi	iki➊si
ikinci	ikin➊ci
iklim	ik➊lim
iktidarı	ik➊ti➊da➊rı
ilgi	il➊gi
ilgili	il➊gi➊li
ilgisi	il➊gi➊si
ilginç	il➊ginç
iltica	il➊ti➊ca
ila	ila
ilaç	ilaç
ilan	ilan
ile	ile
ileri	ile➊ri
ilerleme	iler➊le➊me
iletişim	ile➊ti➊şim
ilişki	iliş➊ki
ilişkiler	iliş➊ki➊ler
ilişkilerde	iliş➊ki➊ler➊de
ilişkileri	iliş➊ki➊le➊ri
ilişkilerin	iliş➊ki➊le➊rin
ilişkilerini	iliş➊ki➊le➊ri➊ni
ilişkilerinin	iliş➊ki➊le➊ri➊nin
ilişkin	iliş➊kin
ilk	ilk
imha	im➊ha
imza	im➊za
imzalanan	im➊za➊la➊nan
imf	imf
inci	in➊ci
ingiliz	in➊gi➊liz
ingiltere	in➊gil➊te➊re
ingiltere‘nin	in➊gil➊te➊re➊‘➊nin
inin	in➊in
insani	in➊sa➊ni
insan	in➊san
internet	in➊ter➊net
internette	in➊ter➊net➊te
intihar	in➊ti➊har
ingiltere‘de	in➊gil➊te➊re➊‘➊de
ingiltere‘nin	in➊gil➊te➊re➊‘➊nin
ini	ini
insanlara	in➊san➊la➊ra
insanlar	in➊san➊lar
insanın	in➊sa➊nın
insanları	in➊san➊la➊rı
insanların	in➊san➊la➊rın
insanlık	in➊san➊lık
inşa	in➊şa
iptal	ip➊tal
irlanda	ir➊lan➊da
irak	irak
ırak‘ta	ırak➊‘➊ta
ırak‘taki	ırak➊‘➊ta➊ki
ırak‘a	ırak➊‘➊a
ırak‘ın	ırak➊‘➊ın
ırak‘a	ırak➊‘➊a
ırak‘ın	ırak➊‘➊ın
ırak‘ta	ırak➊‘➊ta
ırak‘taki	ırak➊‘➊ta➊ki
ırak‘tan	ırak➊‘➊tan
ıraklı	ırak➊lı
ıran	ıran
iran‘a	iran➊‘➊a
iran‘ın	iran➊‘➊ın
iran‘a	iran➊‘➊a
iran‘da	iran➊‘➊da
iran‘ın	iran➊‘➊ın
iranlı	iran➊lı
islami	is➊la➊mi
islam	is➊lam
ismi	is➊mi
israil	is➊ra➊il
israil‘in	is➊ra➊il➊‘➊in
israilli	is➊ra➊il➊li
istedi	is➊te➊di
istediklerini	is➊te➊dik➊le➊ri➊ni
istemiyor	is➊te➊mi➊yor
isteniyor	is➊te➊ni➊yor
ister	is➊ter
isteyen	is➊te➊yen
istikrar	is➊tik➊rar
istihbarat	is➊tih➊ba➊rat
istuhdam	is➊tuh➊dam
istiyor	is➊ti➊yor
istiyoruz	is➊ti➊yo➊ruz
isveç	is➊veç
isviçre	is➊viç➊re
ise	ise
isim	isim
isimler	isim➊ler
isimli	isim➊li
islamcı	is➊lam➊cı
ispanya	is➊pan➊ya
ispanyol	is➊pan➊yol
israil‘e	is➊ra➊il➊‘➊e
israil‘in	is➊ra➊il➊‘➊in
istanbul	is➊tan➊bul
istanbul‘da	is➊tan➊bul➊‘➊da
istanbul‘da	is➊tan➊bul➊‘➊da
istediği	is➊te➊di➊ği
istediğini	is➊te➊di➊ği➊ni
istifa	is➊ti➊fa
istikrarlı	is➊tik➊rar➊lı
işaret	işa➊ret
işbirliği	iş➊bir➊li➊ği
işbirliğine	iş➊bir➊li➊ği➊ne
işbirliğini	iş➊bir➊li➊ği➊ni
işbirliğinin	iş➊bir➊li➊ği➊nin
işçi	iş➊çi
işe	işe
işgal	iş➊gal
işi	işi
işid	işid
işid‘e	işid➊‘➊e
işid‘in	işid➊‘➊in
işin	işin
işine	işi➊ne
işkence	iş➊ken➊ce
işler	iş➊ler
işsiz	iş➊siz
işsizlik	iş➊siz➊lik
işte	iş➊te
işten	iş➊ten
ittifak	it➊ti➊fak
italya	ital➊ya
italyan	ital➊yan
itibaren	iti➊ba➊ren
itiraf	iti➊raf
itiraz	iti➊raz
iyi	iyi
iyimser	iyim➊ser
izliyor	iz➊li➊yor
izni	iz➊ni
izin	izin
izlediği	iz➊le➊di➊ği
japonya	ja➊pon➊ya
japon	ja➊pon
jacques	jacques
jean	jean
jose	jo➊se
joachim	joa➊chim
john	john
juncker	jun➊cker
jürgen	jür➊gen
kabul	ka➊bul
kadar	ka➊dar
kala	ka➊la
kalacak	ka➊la➊cak
kalan	ka➊lan
kaleme	ka➊le➊me
kamu	ka➊mu
kamuoyu	ka➊mu➊o➊yu
kamuoyuna	ka➊mu➊o➊yu➊na
kamuoyunun	ka➊mu➊o➊yu➊nun
kamuoyunda	ka➊mu➊o➊yun➊da
kanada	ka➊na➊da
kara	ka➊ra
karara	ka➊ra➊ra
karar	ka➊rar
kararlar	ka➊rar➊lar
katolik	ka➊to➊lik
kaza	ka➊za
kazanan	ka➊za➊nan
kaç	kaç
kaçak	ka➊çak
kaçınılmaz	ka➊çı➊nıl➊maz
kaçırılan	ka➊çı➊rı➊lan
kaddafi	kad➊da➊fi
kadın	ka➊dın
kadının	ka➊dı➊nın
kadınlar	ka➊dın➊lar
kadınlara	ka➊dın➊la➊ra
kadınların	ka➊dın➊la➊rın
kaide	ka➊i➊de
kalma	kal➊ma
kaldı	kal➊dı
kaldığı	kal➊dı➊ğı
kaldığını	kal➊dı➊ğı➊nı
kaldırılması	kal➊dı➊rıl➊ma➊sı
kalıcı	ka➊lı➊cı
kalıyor	ka➊lı➊yor
kalkınma	kal➊kın➊ma
kalmadı	kal➊ma➊dı
kalması	kal➊ma➊sı
kampanya	kam➊pan➊ya
kampanyası	kam➊pan➊ya➊sı
kan	kan
kanlı	kan➊lı
kapalı	ka➊pa➊lı
kapatılması	ka➊pa➊tıl➊ma➊sı
kapsamında	kap➊sa➊mın➊da
kapsamlı	kap➊sam➊lı
kazzai	kaz➊za➊i
kararı	ka➊ra➊rı
kararın	ka➊ra➊rın
kararına	ka➊ra➊rı➊na
kararını	ka➊ra➊rı➊nı
kararının	ka➊ra➊rı➊nın
kararlı	ka➊rar➊lı
karşı	kar➊şı
karşılandı	kar➊şı➊lan➊dı
karşılığında	kar➊şı➊lı➊ğın➊da
karşılık	kar➊şı➊lık
karşılıklı	kar➊şı➊lık➊lı
karşın	kar➊şın
karşısına	kar➊şı➊sı➊na
karşısında	kar➊şı➊sın➊da
karşıtı	kar➊şı➊tı
karşıya	kar➊şı➊ya
kasım	ka➊sım
kat	kat
katı	ka➊tı
katılacak	ka➊tı➊la➊cak
katılan	ka➊tı➊lan
katıldı	ka➊tıl➊dı
katıldığı	ka➊tıl➊dı➊ğı
katılım	ka➊tı➊lım
katılıyor	ka➊tı➊lı➊yor
katılmak	ka➊tıl➊mak
katkı	kat➊kı
katkıda	kat➊kı➊da
kaybeden	kay➊be➊den
kaybetti	kay➊bet➊ti
kaydeden	kay➊de➊den
kaydediliyor	kay➊de➊di➊li➊yor
kaydedildi	kay➊de➊dil➊di
kaydediyor	kay➊de➊di➊yor
kaydetti	kay➊det➊ti
kaynak	kay➊nak
kaybettiği	kay➊bet➊ti➊ği
kaygı	kay➊gı
kayıp	ka➊yıp
kaynağı	kay➊na➊ğı
kaynakları	kay➊nak➊la➊rı
kazandı	ka➊zan➊dı
kesin	ke➊sin
kesinlikle	ke➊sin➊lik➊le
kendi	ken➊di
kendileri	ken➊di➊le➊ri
kendilerine	ken➊di➊le➊ri➊ne
kendilerini	ken➊di➊le➊ri➊ni
kendine	ken➊di➊ne
kendini	ken➊di➊ni
kendisi	ken➊di➊si
kendisine	ken➊di➊si➊ne
kendisini	ken➊di➊si➊ni
kendisinin	ken➊di➊si➊nin
kentinde	ken➊tin➊de
kentindeki	ken➊tin➊de➊ki
kenti	ken➊ti
kentin	ken➊tin
kent	kent
kentte	kent➊te
kerry	ker➊ry
kez	kez
kıbrıs	kıb➊rıs
kırmızı	kır➊mı➊zı
kısa	kı➊sa
kısmen	kıs➊men
kısmı	kıs➊mı
kış	kış
kıyasla	kı➊yas➊la
kız	kız
kilometre	ki➊lo➊met➊re
kimi	ki➊mi
kimin	ki➊min
kimyasal	kim➊ya➊sal
kitap	ki➊tap
kim	kim
kimse	kim➊se
kimsenin	kim➊se➊nin
kişi	ki➊şi
kişiden	ki➊şi➊den
kişiler	ki➊şi➊ler
kişilerin	ki➊şi➊le➊rin
kişilik	ki➊şi➊lik
kişinin	ki➊şi➊nin
kişisel	ki➊şi➊sel
kişiye	ki➊şi➊ye
kişiyi	ki➊şi➊yi
kitle	kit➊le
klaus	kla➊us
koalisyon	ko➊a➊lis➊yon
koalisyonun	ko➊a➊lis➊yo➊nun
kofi	ko➊fi
kolay	ko➊lay
komisyon	ko➊mis➊yon
komisyonu	ko➊mis➊yo➊nu
komisyonunun	ko➊mis➊yo➊nu➊nun
komitesi	ko➊mi➊te➊si
konu	ko➊nu
konuda	ko➊nu➊da
konudaki	ko➊nu➊da➊ki
konular	ko➊nu➊lar
konilarda	ko➊ni➊lar➊da
konunun	ko➊nu➊nun
konusu	ko➊nu➊su
konusunu	ko➊nu➊su➊nu
konusunda	ko➊nu➊sun➊da
konusundaki	ko➊nu➊sun➊da➊ki
konuya	ko➊nu➊ya
konuk	ko➊nuk
konuyla	ko➊nuy➊la
konuyu	ko➊nu➊yu
kore	ko➊re
kore‘nin	ko➊re➊‘➊nin
koruma	ko➊ru➊ma
korumak	ko➊ru➊mak
koruyor	ko➊ru➊yor
kosova	ko➊so➊va
komisyonu‘nun	ko➊mis➊yo➊nu➊‘➊nun
komşu	kom➊şu
komutanı	ko➊mu➊ta➊nı
konferans	kon➊fe➊rans
konferansta	kon➊fe➊rans➊ta
kongre	kong➊re
konsey	kon➊sey
konseyi	kon➊se➊yi
konseyi‘nin	kon➊se➊yi➊‘➊nin
kontrolü	kont➊ro➊lü
kontrol	kont➊rol
konferansı	kon➊fe➊ran➊sı
konseyi‘nin	kon➊se➊yi➊‘➊nin
konuları	ko➊nu➊la➊rı
konuların	ko➊nu➊la➊rın
konularını	ko➊nu➊la➊rı➊nı
konuşan	ko➊nu➊şan
konuşma	ko➊nuş➊ma
konuşmada	ko➊nuş➊ma➊da
konuşmasında	ko➊nuş➊ma➊sın➊da
konuştu	ko➊nuş➊tu
konuşuyor	ko➊nu➊şu➊yor
korku	kor➊ku
korkusu	kor➊ku➊su
korkunç	kor➊kunç
kore‘nin	kore➊‘➊nin
korunması	ko➊run➊ma➊sı
kosova‘nın	ko➊so➊va➊‘➊nın
koşullar	ko➊şul➊lar
koşulları	ko➊şul➊la➊rı
koydu	koy➊du
koyuyor	ko➊yu➊yor
kökenli	kö➊ken➊li
köln	köln
kötü	kö➊tü
köylü	köy➊lü
kredi	kre➊di
kritik	kri➊tik
krize	kri➊ze
krizi	kri➊zi
krizine	kri➊zi➊ne
krizinin	kri➊zi➊nin
krizin	kri➊zin
kriz	kriz
krizden	kriz➊den
krizle	kriz➊le
kurucusu	ku➊ru➊cu➊su
kurulan	ku➊ru➊lan
kurulu	ku➊ru➊lu
kurumu	ku➊ru➊mu
kurum	ku➊rum
kuzey	ku➊zey
kuzeyinde	ku➊ze➊yin➊de
kuzeyindeki	ku➊ze➊yin➊de➊ki
kullanarak	kul➊la➊na➊rak
kullanan	kul➊la➊nan
kulaksızoğlu	ku➊lak➊sız➊oğ➊lu
kullandı	kul➊lan➊dı
kullandığı	kul➊lan➊dı➊ğı
kullanılan	kul➊la➊nı➊lan
kullanıyor	kul➊la➊nı➊yor
kurban	kur➊ban
kurma	kur➊ma
kurmak	kur➊mak
kurtarma	kur➊tar➊ma
kurtarmak	kur➊tar➊mak
kurulması	ku➊rul➊ma➊sı
kuruluş	ku➊ru➊luş
kuruluşları	ku➊ru➊luş➊la➊rı
kuruluşlarının	ku➊ru➊luş➊la➊rı➊nın
kuruluşu	ku➊ru➊lu➊şu
kuş	kuş
kuşkusuz	kuş➊ku➊suz
küresel	kü➊re➊sel
küçük	kü➊çük
kültürel	kül➊tü➊rel
kültür	kül➊tür
kürt	kürt
kürtler	kürt➊ler
latin	la➊tin
lavrov	lav➊rov
layık	la➊yık
lazım	la➊zım
libya	lib➊ya
liberal	li➊be➊ral
lideri	li➊de➊ri
lider	li➊der
liderleri	li➊der➊le➊ri
liderler	li➊der➊ler
ligi	li➊gi
liderliğindeki	li➊der➊li➊ğin➊de➊ki
lik	lik
lizbon	liz➊bon
londra	lond➊ra
lübnan	lüb➊nan
macaristan	ma➊ca➊ris➊tan
madde	mad➊de
maddesi	mad➊de➊si
madidi	madi➊di
mali	ma➊li
maliki	ma➊li➊ki
maliye	ma➊li➊ye
manuel	ma➊nu➊el
maruz	ma➊ruz
masaya	ma➊sa➊ya
maçında	ma➊çın➊da
maçta	maç➊ta
mahkeme	mah➊ke➊me
mahkemenin	mah➊ke➊me➊nin
mahkemesi	mah➊ke➊me➊si
mahkemeye	mah➊ke➊me➊ye
mahkum	mah➊kum
mahmud	mah➊mud
mal	mal
martin	mar➊tin
mart	mart
mayıs	ma➊yıs
meclisi	mec➊li➊si
meclis	mec➊lis
mecliste	mec➊lis➊te
merak	me➊rak
metre	met➊re
medvedev	med➊ve➊dev
medya	med➊ya
medyada	med➊ya➊da
mehmet	meh➊met
meksika	mek➊si➊ka
memnun	mem➊nun
memnuniyetle	mem➊nu➊ni➊yet➊le
mercek	mer➊cek
merkezi	mer➊ke➊zi
merkezinde	mer➊ke➊zin➊de
merkel	mer➊kel
merkel‘in	mer➊kel➊‘➊in
merkez	mer➊kez
merkezli	mer➊kez➊li
merkel‘in	mer➊kel➊‘➊in
meslek	mes➊lek
mesajlar	me➊saj➊lar
mesaj	me➊saj
mesajı	me➊sa➊jı
mesajını	me➊sa➊jı➊nı
meşru	meş➊ru
mevcut	mev➊cut
meydana	mey➊da➊na
mısır	mı➊sır
mısır‘da	mı➊sır➊‘➊da
michael	mi➊cha➊el
milyon	mil➊yon
milyar	mil➊yar
milyarlarca	mil➊yar➊lar➊ca
milyonlarca	mil➊yon➊lar➊ca
milletler	mil➊let➊ler
milletvekili	mil➊let➊ve➊ki➊li
milletvekilleri	mil➊let➊ve➊kil➊le➊ri
milletvekillerinin	mil➊let➊ve➊kil➊le➊ri➊nin
mili	mi➊li
milliyetçi	mil➊li➊yet➊çi
modern	mo➊dern
moskova	mos➊ko➊va
muhabiri	mu➊ha➊bi➊ri
muhalif	mu➊ha➊lif
muhafazakar	mu➊ha➊fa➊za➊kar
muhafazakar	mu➊ha➊fa➊za➊kar
muhammed	mu➊ham➊med
murat	mu➊rat
muhtemelen	muh➊te➊me➊len
muhtemel	muh➊te➊mel
muhalefetin	mu➊ha➊le➊fe➊tin
muhalefet	mu➊ha➊le➊fet
muhalefetteki	mu➊ha➊le➊fet➊te➊ki
mutlaka	mut➊la➊ka
mutlu	mut➊lu
mücadele	mü➊ca➊de➊le
mücadelede	mü➊ca➊de➊le➊de
mücadelenin	mü➊ca➊de➊le➊nin
mücadelesi	mü➊ca➊de➊le➊si
mücadeleye	mü➊ca➊de➊le➊ye
müdürü	mü➊dü➊rü
münih	mü➊nih
müzik	mü➊zik
müdahale	mü➊da➊ha➊le
mülteci	mül➊te➊ci
mültecilere	mül➊te➊ci➊le➊re
mültecilerin	mül➊te➊ci➊le➊rin
mülteciler	mül➊te➊ci➊ler
mümkün	müm➊kün
müslümanlar	müs➊lü➊man➊lar
müslüman	müs➊lü➊man
müslümanların	müs➊lü➊man➊la➊rın
müzakere	mü➊za➊ke➊re
müzakerelere	mü➊za➊ke➊re➊le➊re
müzakereleri	mü➊za➊ke➊re➊le➊ri
müzakerelerin	mü➊za➊ke➊re➊le➊rin
müzakereler	mü➊za➊ke➊re➊ler
müzakerelerinin	mü➊za➊ke➊re➊le➊ri➊nin
nasyonal	nas➊yo➊nal
nato	na➊to
nato‘nun	na➊to➊‘➊nun
nazi	na➊zi
nacrichten	nac➊rich➊ten
nasıl	na➊sıl
nato‘nun	na➊to➊‘➊nun
nci	nci
nedeni	ne➊de➊ni
nedeniyle	ne➊de➊niy➊le
neden	ne➊den
nedenle	ne➊den➊le
nefret	nef➊ret
neler	ne➊ler
nerede	ne➊re➊de
neredeyse	ne➊re➊dey➊se
netanyahu	ne➊tan➊ya➊hu
net	net
neue	neue
new	new
nın	nın
nicolas	ni➊co➊las
nihai	ni➊ha➊i
nihayet	ni➊ha➊yet
nisan	ni➊san
nitekim	ni➊te➊kim
nin	nin
nobel	no➊bel
noel	no➊el
nokta	nok➊ta
noktada	nok➊ta➊da
noktası	nok➊ta➊sı
normal	nor➊mal
nsu	nsu
nüfusun	nü➊fu➊sun
nüfus	nü➊fus
nükleer	nük➊le➊er
obama	oba➊ma
obama‘nın	oba➊ma➊‘➊nın
obama‘nın	oba➊ma➊‘➊nın
ocak	ocak
okul	okul
okuyoruz	oku➊yo➊ruz
olanlar	olan➊lar
oldu	ol➊du
oldukça	ol➊duk➊ça
olma	ol➊ma
olmadan	ol➊ma➊dan
olmasa	ol➊ma➊sa
olmayan	ol➊ma➊yan
olmaya	ol➊ma➊ya
olmayacak	ol➊ma➊ya➊cak
olmak	ol➊mak
olmaktan	ol➊mak➊tan
olmaz	ol➊maz
olmert	ol➊mert
olsa	ol➊sa
olsun	ol➊sun
olabilir	ola➊bi➊lir
olacak	ola➊cak
olamaz	ola➊maz
olarak	ola➊rak
olabileceği	ola➊bi➊le➊ce➊ği
olabileceğini	ola➊bi➊le➊ce➊ği➊ni
olacağı	ola➊ca➊ğı
olacağını	ola➊ca➊ğı➊nı
olacaktır	ola➊cak➊tır
olağanüstü	ola➊ğan➊üs➊tü
olan	olan
olanların	olan➊la➊rın
olası	ola➊sı
olay	olay
olayda	olay➊da
olayı	ola➊yı
olayın	ola➊yın
olaylar	olay➊lar
olayları	olay➊la➊rı
olayların	olay➊la➊rın
olaylarının	olay➊la➊rı➊nın
olduğu	ol➊du➊ğu
olduğuna	ol➊du➊ğu➊na
olduğundan	ol➊du➊ğun➊dan
olduğunu	ol➊du➊ğu➊nu
olduğunun	ol➊du➊ğu➊nun
oldukları	ol➊duk➊la➊rı
olduklarını	ol➊duk➊la➊rı➊nı
olimpiyat	olim➊pi➊yat
olmadı	ol➊ma➊dı
olmadığı	ol➊ma➊dı➊ğı
olmadığına	ol➊ma➊dı➊ğı➊na
olmadığını	ol➊ma➊dı➊ğı➊nı
olmaları	ol➊ma➊la➊rı
olmalı	ol➊ma➊lı
olmaması	ol➊ma➊ma➊sı
olması	ol➊ma➊sı
olmasına	ol➊ma➊sı➊na
olmasından	ol➊ma➊sın➊dan
olmasını	ol➊ma➊sı➊nı
olmasının	ol➊ma➊sı➊nın
olmayacağını	ol➊ma➊ya➊ca➊ğı➊nı
olmayı	ol➊ma➊yı
olmuş	ol➊muş
olmuştu	ol➊muş➊tu
olumlu	olum➊lu
olumsuz	olum➊suz
olup	olup
olur	olur
olurdu	olur➊du
olursa	olur➊sa
oluşan	olu➊şan
oluşturan	oluş➊tu➊ran
oluşturduğu	oluş➊tur➊du➊ğu
oluşturulan	oluş➊tu➊ru➊lan
oluşturulması	oluş➊tu➊rul➊ma➊sı
oluşturuyor	oluş➊tu➊ru➊yor
oluyor	olu➊yor
ona	ona
onay	onay
onlara	on➊la➊ra
onlar	on➊lar
onlarca	on➊lar➊ca
onları	on➊la➊rı
onların	on➊la➊rın
onu	onu
onun	onun
operasyon	ope➊ras➊yon
operasyonu	ope➊ras➊yo➊nu
operasyonun	ope➊ras➊yo➊nun
operasyonda	ope➊ras➊yon➊da
oranla	oran➊la
ordu	or➊du
ordunun	or➊du➊nun
ordusu	or➊du➊su
ordusunun	or➊du➊su➊nun
organize	or➊ga➊ni➊ze
orta	or➊ta
ortada	or➊ta➊da
ortadan	or➊ta➊dan
ortaya	or➊ta➊ya
ortak	or➊tak
ortalama	or➊ta➊la➊ma
ortamda	or➊tam➊da
orada	ora➊da
oranla	oran➊la
oranda	oran➊da
oranı	ora➊nı
oranında	ora➊nın➊da
oranının	ora➊nı➊nın
ortadoğu	or➊ta➊do➊ğu
ortadoğu‘da	or➊ta➊do➊ğu➊‘➊da
ortağı	or➊ta➊ğı
ortaklık	or➊tak➊lık
ortasında	or➊ta➊sın➊da
otomobil	oto➊mo➊bil
otomotiv	oto➊mo➊tiv
oynanan	oy➊na➊nan
oynuyor	oy➊nu➊yor
oysa	oy➊sa
oylama	oy➊la➊ma
oylamada	oy➊la➊ma➊da
oyların	oy➊la➊rın
oynadığı	oy➊na➊dı➊ğı
oyu	oyu
oyunu	oyu➊nu
oyun	oyun
oyuncu	oyun➊cu
ödülü	ödü➊lü
ödül	ödül
öğrenci	öğ➊ren➊ci
öğrencilerin	öğ➊ren➊ci➊le➊rin
öğretim	öğ➊re➊tim
öldü	öl➊dü
öldürülen	öl➊dü➊rü➊len
öldürüldü	öl➊dü➊rül➊dü
ölçüde	öl➊çü➊de
öldüğü	öl➊dü➊ğü
öldüğünü	öl➊dü➊ğü➊nü
öldürüldüğü	öl➊dü➊rül➊dü➊ğü
ölen	ölen
ölenlerin	ölen➊le➊rin
ölü	ölü
ölümü	ölü➊mü
ölümüne	ölü➊mü➊ne
ölüm	ölüm
önce	ön➊ce
önceden	ön➊ce➊den
önceki	ön➊ce➊ki
öncelikle	ön➊ce➊lik➊le
öncesi	ön➊ce➊si
öncesine	ön➊ce➊si➊ne
öncesinde	ön➊ce➊sin➊de
önde	ön➊de
öngören	ön➊gö➊ren
öngörülen	ön➊gö➊rü➊len
öngörülüyor	ön➊gö➊rü➊lü➊yor
öngörüyor	ön➊gö➊rü➊yor
önlemek	ön➊le➊mek
önlem	ön➊lem
önlemleri	ön➊lem➊le➊ri
önlemlerin	ön➊lem➊le➊rin
önlemler	ön➊lem➊ler
öne	öne
önemi	öne➊mi
önemine	öne➊mi➊ne
önemini	öne➊mi➊ni
öneri	öne➊ri
önerisi	öne➊ri➊si
önem	önem
önemli	önem➊li
önumüzdeki	önu➊müz➊de➊ki
önüne	önü➊ne
önünde	önün➊de
önündeki	önün➊de➊ki
örgüt	ör➊güt
örgütleri	ör➊güt➊le➊ri
örgütü	ör➊gü➊tü
örgütüne	ör➊gü➊tü➊ne
örgütün	ör➊gü➊tün
örgütünün	ör➊gü➊tü➊nün
örnek	ör➊nek
örneğin	ör➊ne➊ğin
öte	öte
ötürü	ötü➊rü
öyle	öy➊le
özdemir	öz➊de➊mir
özgür	öz➊gür
özgürlük	öz➊gür➊lük
özay	özay
özel	özel
özellikle	özel➊lik➊le
özerk	özerk
özetler	özet➊ler
özgürlüğü	öz➊gür➊lü➊ğü
özgürlüğünün	öz➊gür➊lü➊ğü➊nün
özür	özür
paketi	pa➊ke➊ti
pakistan	pa➊kis➊tan
papa	pa➊pa
para	pa➊ra
paris	pa➊ris
pazar	pa➊zar
pazartesi	pa➊zar➊te➊si
parlamento	par➊la➊men➊to
parlamentoda	par➊la➊men➊to➊da
parlamentonun	par➊la➊men➊to➊nun
parlamentosu	par➊la➊men➊to➊su
parti	par➊ti
parti‘nin	par➊ti➊‘➊nin
partileri	par➊ti➊le➊ri
partilerin	par➊ti➊le➊rin
partiler	par➊ti➊ler
partilerinin	par➊ti➊le➊ri➊nin
partili	par➊ti➊li
partinin	par➊ti➊nin
partisi	par➊ti➊si
partisi‘nin	par➊ti➊si➊‘➊nin
partisinin	par➊ti➊si➊nin
parçası	par➊ça➊sı
parti‘nin	par➊ti➊‘➊nin
partisi‘nin	par➊ti➊si➊‘➊nin
patlama	pat➊la➊ma
patlak	pat➊lak
paul	paul
payı	pa➊yı
peki	pe➊ki
pekin	pe➊kin
peter	pe➊ter
petrol	pet➊rol
pek	pek
personel	per➊so➊nel
perşembe	per➊şem➊be
piyasa	pi➊ya➊sa
piyasaya	pi➊ya➊sa➊ya
pkk	pkk
planlanan	plan➊la➊nan
plana	pla➊na
plan	plan
planda	plan➊da
planı	pla➊nı
planını	pla➊nı➊nı
planladığı	plan➊la➊dı➊ğı
planlanıyor	plan➊la➊nı➊yor
planları	plan➊la➊rı
planlıyor	plan➊lı➊yor
polise	po➊li➊se
polisi	po➊li➊si
polisin	po➊li➊sin
politika	po➊li➊ti➊ka
politikada	po➊li➊ti➊ka➊da
politik	po➊li➊tik
polis	po➊lis
polonya	po➊lon➊ya
politikacı	po➊li➊ti➊ka➊cı
politikacılar	po➊li➊ti➊ka➊cı➊lar
politikacıların	po➊li➊ti➊ka➊cı➊la➊rın
politikaları	po➊li➊ti➊ka➊la➊rı
politikası	po➊li➊ti➊ka➊sı
politikasına	po➊li➊ti➊ka➊sı➊na
politikasında	po➊li➊ti➊ka➊sın➊da
politikasını	po➊li➊ti➊ka➊sı➊nı
politikasının	po➊li➊ti➊ka➊sı➊nın
popülist	po➊pü➊list
portekiz	por➊te➊kiz
post	post
program	prog➊ram
proje	pro➊je
projesi	pro➊je➊si
protesto	pro➊tes➊to
protestolar	pro➊tes➊to➊lar
prof	prof
programı	prog➊ra➊mı
programına	prog➊ra➊mı➊na
programını	prog➊ra➊mı➊nı
programının	prog➊ra➊mı➊nın
puan	pu➊an
putin	pu➊tin
putin‘in	pu➊tin➊‘➊in
putin‘in	pu➊tin➊‘➊in
radikal	ra➊di➊kal
radyo	rad➊yo
rahat	ra➊hat
rakam	ra➊kam
rakibi	ra➊ki➊bi
rakip	ra➊kip
rapora	ra➊po➊ra
rapor	ra➊por
raporda	ra➊por➊da
raporu	ra➊po➊ru
raporuna	ra➊po➊ru➊na
raporunu	ra➊po➊ru➊nu
raporun	ra➊po➊run
raporunda	ra➊po➊run➊da
rağmen	rağ➊men
rahatsız	ra➊hat➊sız
recep	re➊cep
refah	re➊fah
referanduma	re➊fe➊ran➊du➊ma
referandum	re➊fe➊ran➊dum
reform	re➊form
reformlar	re➊form➊lar
rehin	re➊hin
rejimi	re➊ji➊mi
rejiminin	re➊ji➊mi➊nin
rejim	re➊jim
rekabet	re➊ka➊bet
rekor	re➊kor
reddetti	red➊det➊ti
reformların	re➊form➊la➊rın
ren	ren
resmen	res➊men
resmi	res➊mi
ret	ret
reuters	reu➊ters
rice	rice
risk	risk
robert	ro➊bert
rolü	ro➊lü
romanya	ro➊man➊ya
rol	rol
rtr	rtr
rusya	rus➊ya
rusya‘ya	rus➊ya➊‘➊ya
rum	rum
rundschau	rund➊schau
rus	rus
rusya‘nın	rus➊ya➊‘➊nın
rusya‘da	rus➊ya➊‘➊da
rusya‘nın	rus➊ya➊‘➊nın
rusya‘ya	rus➊ya➊‘➊ya
rüşvet	rüş➊vet
sabah	sa➊bah
sadece	sa➊de➊ce
sahibi	sa➊hi➊bi
sahip	sa➊hip
sanat	sa➊nat
saray	sa➊ray
savunan	sa➊vu➊nan
savunuyor	sa➊vu➊nu➊yor
savundu	sa➊vun➊du
savunma	sa➊vun➊ma
saat	sa➊at
saatlerinde	sa➊at➊le➊rin➊de
saddam	sad➊dam
sağ	sağ
sağcı	sağ➊cı
sağladı	sağ➊la➊dı
sağlamak	sağ➊la➊mak
sağlanması	sağ➊lan➊ma➊sı
sağlayacak	sağ➊la➊ya➊cak
sağlayan	sağ➊la➊yan
sağlık	sağ➊lık
sağlıyor	sağ➊lı➊yor
sahne	sah➊ne
sahipliği	sa➊hip➊li➊ği
saksonya	sak➊son➊ya
saldırgan	sal➊dır➊gan
saldırganın	sal➊dır➊ga➊nın
saldırı	sal➊dı➊rı
saldırıda	sal➊dı➊rı➊da
saldırılar	sal➊dı➊rı➊lar
saldırılarda	sal➊dı➊rı➊lar➊da
saldırıları	sal➊dı➊rı➊la➊rı
saldırıların	sal➊dı➊rı➊la➊rın
saldırılarını	sal➊dı➊rı➊la➊rı➊nı
saldırılarının	sal➊dı➊rı➊la➊rı➊nın
saldırının	sal➊dı➊rı➊nın
saldırısı	sal➊dı➊rı➊sı
saldırısında	sal➊dı➊rı➊sın➊da
saldırısının	sal➊dı➊rı➊sı➊nın
saldırıya	sal➊dı➊rı➊ya
saldırıyı	sal➊dı➊rı➊yı
salı	sa➊lı
sanayi	sa➊na➊yi
sandık	san➊dık
sanık	sa➊nık
sarkozy	sar➊ko➊zy
sarkozy‘nin	sar➊ko➊zy➊‘➊nin
satın	sa➊tın
satırlar	sa➊tır➊lar
satırları	sa➊tır➊la➊rı
satış	sa➊tış
savaş	sa➊vaş
savaşa	sa➊va➊şa
savaşı	sa➊va➊şı
savaşın	sa➊va➊şın
savaşta	sa➊vaş➊ta
sayesinde	sa➊ye➊sin➊de
saygı	say➊gı
sayıda	sa➊yı➊da
sayın	sa➊yın
sayısı	sa➊yı➊sı
sayısında	sa➊yı➊sın➊da
sayısını	sa➊yı➊sı➊nı
sayısının	sa➊yı➊sı➊nın
schröder	sch➊rö➊der
schröder‘in	sch➊rö➊der➊‘➊in
schulz	schulz
sekiz	se➊kiz
sekreteri	sek➊re➊te➊ri
sera	se➊ra
sezon	se➊zon
seçmenin	seç➊me➊nin
seçmen	seç➊men
seçmenlerin	seç➊men➊le➊rin
seçilen	se➊çi➊len
seçime	se➊çi➊me
seçimi	se➊çi➊mi
seçimin	se➊çi➊min
seçildi	se➊çil➊di
seçim	se➊çim
seçimlere	se➊çim➊le➊re
seçimleri	se➊çim➊le➊ri
seçimlerine	se➊çim➊le➊ri➊ne
seçimlerin	se➊çim➊le➊rin
seçimler	se➊çim➊ler
seçimlerinin	se➊çim➊le➊ri➊nin
seçimlerinde	se➊çim➊le➊rin➊de
seçimlerde	se➊çim➊ler➊de
seçimlerden	se➊çim➊ler➊den
seçtiğimiz	seç➊ti➊ği➊miz
sel	sel
serbest	ser➊best
sergey	ser➊gey
sermaye	ser➊ma➊ye
sert	sert
servisi	ser➊vi➊si
ses	ses
seyahat	se➊ya➊hat
sıcak	sı➊cak
sığınmacı	sı➊ğın➊ma➊cı
sığınmacıların	sı➊ğın➊ma➊cı➊la➊rın
sık	sık
sıkı	sı➊kı
sınır	sı➊nır
sınırdışı	sı➊nır➊dı➊şı
sınırı	sı➊nı➊rı
sınırında	sı➊nı➊rın➊da
sınırları	sı➊nır➊la➊rı
sınırlı	sı➊nır➊lı
sıra	sı➊ra
sırada	sı➊ra➊da
sırasında	sı➊ra➊sın➊da
sırbistan	sır➊bis➊tan
sırp	sırp
siber	si➊ber
sigara	si➊ga➊ra
silah	si➊lah
sivil	si➊vil
sivillerin	si➊vil➊le➊rin
sigmar	sig➊mar
silahların	si➊lah➊la➊rın
silahlı	si➊lah➊lı
sistemi	sis➊te➊mi
sistemine	sis➊te➊mi➊ne
sisteminin	sis➊te➊mi➊nin
sistemin	sis➊te➊min
sistem	sis➊tem
siyaset	si➊ya➊set
siyasi	si➊ya➊si
siyah	si➊yah
siyasi	si➊ya➊si
skandal	skan➊dal
skandalı	skan➊da➊lı
somut	so➊mut
sona	so➊na
sonu	so➊nu
sonucu	so➊nu➊cu
sonucunda	so➊nu➊cun➊da
sonuna	so➊nu➊na
sonuç	so➊nuç
sonuçlara	so➊nuç➊la➊ra
sonuçlar	so➊nuç➊lar
sorusuna	so➊ru➊su➊na
sosyalist	sos➊ya➊list
sosyal	sos➊yal
sovyetler	sov➊yet➊ler
soğuk	so➊ğuk
sokağa	so➊ka➊ğa
sol	sol
son	son
sonra	son➊ra
sonraki	son➊ra➊ki
sonunda	so➊nun➊da
sonrası	son➊ra➊sı
sonrasında	son➊ra➊sın➊da
sonuçları	so➊nuç➊la➊rı
sonuçlarına	so➊nuç➊la➊rı➊na
sonuçlarını	so➊nuç➊la➊rı➊nı
sorumlu	so➊rum➊lu
sorumluluk	so➊rum➊lu➊luk
sorumlusu	so➊rum➊lu➊su
soru	so➊ru
sorunu	so➊ru➊nu
sorununun	so➊ru➊nu➊nun
sorunun	so➊ru➊nun
sorularını	so➊ru➊la➊rı➊nı
sorumluluğu	so➊rum➊lu➊lu➊ğu
sorumluluğunu	so➊rum➊lu➊lu➊ğu➊nu
sorun	so➊run
sorunlar	so➊run➊lar
sorunları	so➊run➊la➊rı
sorunların	so➊run➊la➊rın
soruşturma	so➊ruş➊tur➊ma
soykırım	soy➊kı➊rım
söyledi	söy➊le➊di
söylemek	söy➊le➊mek
söyleyerek	söy➊le➊ye➊rek
söylenen	söy➊le➊nen
söylüyor	söy➊lü➊yor
söylemişti	söy➊le➊miş➊ti
söz	söz
sözcü	söz➊cü
sözcüsü	söz➊cü➊sü
sözkonusu	söz➊ko➊nu➊su
sözleri	söz➊le➊ri
sözlerine	söz➊le➊ri➊ne
sözleriyle	söz➊le➊riy➊le
sözler	söz➊ler
sözlerini	söz➊le➊ri➊ni
sözlerle	söz➊ler➊le
sözü	sö➊zü
spd	spd
spiegel	spie➊gel
spor	spor
steinmeier	stein➊mei➊er
strateji	stra➊te➊ji
stratejik	stra➊te➊jik
sudan	su➊dan
suriye	su➊ri➊ye
suriye‘de	su➊ri➊ye➊‘➊de
suriye‘deki	su➊ri➊ye➊‘➊de➊ki
suriye‘nin	su➊ri➊ye➊‘➊nin
suriye‘ye	su➊ri➊ye➊‘➊ye
suriyeli	su➊ri➊ye➊li
suudi	su➊u➊di
suç	suç
suçladı	suç➊la➊dı
suçlamaları	suç➊la➊ma➊la➊rı
suçları	suç➊la➊rı
suçlu	suç➊lu
suçu	su➊çu
sunduğu	sun➊du➊ğu
suriye‘de	su➊ri➊ye➊‘➊de
suriye‘deki	su➊ri➊ye➊‘➊de➊ki
suriye‘nin	su➊ri➊ye➊‘➊nin
süper	sü➊per
süre	sü➊re
sürece	sü➊re➊ce
sürecek	sü➊re➊cek
süreci	sü➊re➊ci
sürecine	sü➊re➊ci➊ne
sürecini	sü➊re➊ci➊ni
sürecinin	sü➊re➊ci➊nin
sürecin	sü➊re➊cin
sürecinde	sü➊re➊cin➊de
sürede	sü➊re➊de
süredir	sü➊re➊dir
sürekli	sü➊rek➊li
süresi	sü➊re➊si
süresinin	sü➊re➊si➊nin
süreç	sü➊reç
süren	sü➊ren
süddeutsche	süd➊deut➊sche
sünni	sün➊ni
sürdü	sür➊dü
sürdürdü	sür➊dür➊dü
sürdürüyor	sür➊dü➊rü➊yor
sürpriz	sürp➊riz
sürdüğü	sür➊dü➊ğü
sürüyor	sü➊rü➊yor
sütunlarına	sü➊tun➊la➊rı➊na
şam	şam
şampiyonası	şam➊pi➊yo➊na➊sı
şampiyonlar	şam➊pi➊yon➊lar
şampiyonu	şam➊pi➊yo➊nu
şans	şans
şansı	şan➊sı
şaron	şa➊ron
şart	şart
şehir	şe➊hir
şekilde	şe➊kil➊de
şeklinde	şek➊lin➊de
şeklindeki	şek➊lin➊de➊ki
şey	şey
şeyi	şe➊yi
şeyler	şey➊ler
şiddet	şid➊det
şiddete	şid➊de➊te
şiddetin	şid➊de➊tin
şiddetli	şid➊det➊li
şii	şii
şimdi	şim➊di
şimdiden	şim➊di➊den
şimdiki	şim➊di➊ki
şimdilik	şim➊di➊lik
şimdiye	şim➊di➊ye
şirket	şir➊ket
şirketi	şir➊ke➊ti
şirketin	şir➊ke➊tin
şirketinin	şir➊ke➊ti➊nin
şirketler	şir➊ket➊ler
şirketleri	şir➊ket➊le➊ri
şirketlerin	şir➊ket➊le➊rin
şirketlerinin	şir➊ket➊le➊ri➊nin
şöyle	şöy➊le
şubat	şu➊bat
şunları	şun➊la➊rı
şunu	şu➊nu
şüphe	şüp➊he
şüpheli	şüp➊he➊li
tabi	ta➊bi
tabii	ta➊bii
tagesspiegel	ta➊ges➊spie➊gel
takip	ta➊kip
talebi	ta➊le➊bi
talebini	ta➊le➊bi➊ni
talebinde	ta➊le➊bin➊de
talep	ta➊lep
talepleri	ta➊lep➊le➊ri
taliban	ta➊li➊ban
tamamen	ta➊ma➊men
tarihe	ta➊ri➊he
tarihi	ta➊ri➊hi
tarihinin	ta➊ri➊hi➊nin
tarihinde	ta➊ri➊hin➊de
tarih	ta➊rih
tarihli	ta➊rih➊li
tasarruf	ta➊sar➊ruf
tatil	ta➊til
tablo	tab➊lo
tahliye	tah➊li➊ye
tahmin	tah➊min
tahran	tah➊ran
takdirde	tak➊dir➊de
takım	ta➊kım
takımı	ta➊kı➊mı
tam	tam
tanık	ta➊nık
tanınan	ta➊nı➊nan
taraf	ta➊raf
taraflar	ta➊raf➊lar
taraftan	ta➊raf➊tan
tarafı	ta➊ra➊fı
tarafın	ta➊ra➊fın
tarafından	ta➊ra➊fın➊dan
tarafların	ta➊raf➊la➊rın
taraflı	ta➊raf➊lı
tarım	ta➊rım
tartışılıyor	tar➊tı➊şı➊lı➊yor
tartışma	tar➊tış➊ma
tartışmalar	tar➊tış➊ma➊lar
tartışmalara	tar➊tış➊ma➊la➊ra
tartışmaları	tar➊tış➊ma➊la➊rı
tartışmaların	tar➊tış➊ma➊la➊rın
tartışmalı	tar➊tış➊ma➊lı
tartışması	tar➊tış➊ma➊sı
tartışmaya	tar➊tış➊ma➊ya
tasarısı	ta➊sa➊rı➊sı
taşıdığını	ta➊şı➊dı➊ğı➊nı
taşıyan	ta➊şı➊yan
taşıyor	ta➊şı➊yor
tavır	ta➊vır
tavrı	tav➊rı
tavsiye	tav➊si➊ye
tayyip	tay➊yip
tazminat	taz➊mi➊nat
tedavi	te➊da➊vi
teknik	tek➊nik
teknoloji	tek➊no➊lo➊ji
tekrar	tek➊rar
telefon	te➊le➊fon
televizyon	te➊le➊viz➊yon
televizyonu	te➊le➊viz➊yo➊nu
temaslarda	te➊mas➊lar➊da
temel	te➊mel
tespit	tes➊pit
tehdidi	teh➊di➊di
tehdit	teh➊dit
tehlike	teh➊li➊ke
tehlileli	teh➊li➊le➊li
tehlikesi	teh➊li➊ke➊si
tehlikeye	teh➊li➊ke➊ye
tek	tek
temkinli	tem➊kin➊li
temmuz	tem➊muz
temsil	tem➊sil
temsilcileri	tem➊sil➊ci➊le➊ri
temsilciler	tem➊sil➊ci➊ler
temsilcisi	tem➊sil➊ci➊si
ten	ten
tepki	tep➊ki
tepkiler	tep➊ki➊ler
tepkisi	tep➊ki➊si
tercih	ter➊cih
terör	te➊rör
terörle	te➊rör➊le
teröre	te➊rö➊re
terörist	te➊rö➊rist
teröristlerin	te➊rö➊rist➊le➊rin
terörün	te➊rö➊rün
tersine	ter➊si➊ne
terk	terk
teslim	tes➊lim
teşekkür	te➊şek➊kür
teşkil	teş➊kil
teşkilatı	teş➊ki➊la➊tı
teşvik	teş➊vik
the	the
thomas	tho➊mas
tıpkı	tıp➊kı
ticari	ti➊ca➊ri
ticareti	ti➊ca➊re➊ti
ticaret	ti➊ca➊ret
tipi	ti➊pi
times	times
toplanan	top➊la➊nan
toplam	top➊lam
toplu	top➊lu
topluma	top➊lu➊ma
toplumu	top➊lu➊mu
toplumun	top➊lu➊mun
toplum	top➊lum
toplumsal	top➊lum➊sal
toprak	top➊rak
tony	tony
toplantı	top➊lan➊tı
toplantıda	top➊lan➊tı➊da
toplantının	top➊lantı➊nın
toplantısı	top➊lan➊tı➊sı
toplantısında	top➊lan➊tı➊sın➊da
toplantıya	top➊lan➊tı➊ya
töreni	tö➊re➊ni
tren	tren
trump	trump
trump‘ın	trump➊‘➊ın
tsunami	tsu➊na➊mi
turizm	tu➊rizm
turu	tu➊ru
tutuklama	tu➊tuk➊la➊ma
tutulan	tu➊tu➊lan
tutumu	tu➊tu➊mu
tutumunu	tu➊tu➊mu➊nu
tutuklu	tu➊tuk➊lu
tutum	tu➊tum
tutuyor	tu➊tu➊yor
tur	tur
tüm	tüm
tür	tür
türkiye	tür➊ki➊ye
türkiye‘de	tür➊ki➊ye➊‘➊de
türkiye‘deki	tür➊ki➊ye➊‘➊de➊ki
türkiye‘den	tür➊ki➊ye➊‘➊den
türkiye‘nin	tür➊ki➊ye➊‘➊nin
türkiye‘ye	tür➊ki➊ye➊‘➊ye
türkiye‘yi	tür➊ki➊ye➊‘➊yi
türlü	tür➊lü
türk	türk
türklerin	türk➊le➊rin
türkler	türk➊ler
türkçe	türk➊çe
türkiye‘de	tür➊ki➊ye➊‘➊de
türkiye‘deki	tür➊ki➊ye➊‘➊de➊ki
türkiye‘den	tür➊ki➊ye➊‘➊den
türkiye‘nin	tür➊ki➊ye➊‘➊nin
türkiye‘ye	tür➊ki➊ye➊‘➊ye
türkiye‘yi	tür➊ki➊ye➊‘➊yi
twitter	twit➊ter
ucuz	ucuz
uçağı	uça➊ğı
uçağın	uça➊ğın
uçak	uçak
uçuş	uçuş
uefa	ue➊fa
ukrayna	uk➊ray➊na
ukrayna‘nın	uk➊ray➊na➊‘➊nın
ulaştı	ulaş➊tı
ulusal	ulu➊sal
uluslararası	u➊lus➊la➊ra➊ra➊sı
umut	umut
uranyum	uran➊yum
uygulama	uy➊gu➊la➊ma
uygulamaya	uy➊gu➊la➊ma➊ya
uygulanan	uy➊gu➊la➊nan
uygun	uy➊gun
uyardı	uyar➊dı
uyarı	uya➊rı
uyarıda	uya➊rı➊da
uyarınca	uya➊rın➊ca
uyarısı	uya➊rı➊sı
uyarısında	uya➊rı➊sın➊da
uyguladığı	uy➊gu➊la➊dı➊ğı
uygulaması	uy➊gu➊la➊ma➊sı
uygulanması	uy➊gu➊lan➊ma➊sı
uyum	uyum
uyuşturucu	uyuş➊tu➊ru➊cu
uzak	uzak
uzmanlar	uz➊man➊lar
uzman	uz➊man
uzay	uzay
uzlaşma	uz➊laş➊ma
uzlaşmaya	uz➊laş➊ma➊ya
uzmanı	uz➊ma➊nı
uzmanları	uz➊man➊la➊rı
uzun	uzun
ücret	üc➊ret
üçte	üç➊te
üçüncü	üçün➊cü
ülke	ül➊ke
ülkede	ül➊ke➊de
ülkedeki	ül➊ke➊de➊ki
ülkeden	ül➊ke➊den
ülkelere	ül➊ke➊le➊re
ülkeleri	ül➊ke➊le➊ri
ülkelerine	ül➊ke➊le➊ri➊ne
ülkelerin	ül➊ke➊le➊rin
ülkeler	ül➊ke➊ler
ülkelerinin	ül➊ke➊le➊ri➊nin
ülkelerini	ül➊ke➊le➊ri➊ni
ülkelerle	ül➊ke➊ler➊le
ülkelerinde	ül➊ke➊le➊rin➊de
ülkelerindeki	ül➊ke➊le➊rin➊de➊ki
ülkelerinden	ül➊ke➊le➊rin➊den
ülkenin	ül➊ke➊nin
ülkesi	ül➊ke➊si
ülkesine	ül➊ke➊si➊ne
ülkesinin	ül➊ke➊si➊nin
ülkesinde	ül➊ke➊sin➊de
ülkelerde	ül➊ke➊ler➊de
ülkelerdeki	ül➊ke➊ler➊de➊ki
ülkelerden	ül➊ke➊ler➊den
ülkeye	ül➊ke➊ye
ülkeyi	ül➊ke➊yi
üncü	ün➊cü
ünlü	ün➊lü
üniversite	üni➊ver➊si➊te
üniversitesi	üni➊ver➊si➊te➊si
ürdün	ür➊dün
üretim	üre➊tim
üstelik	üs➊te➊lik
üst	üst
üye	üye
üyeleri	üye➊le➊ri
üyelerinin	üye➊le➊ri➊nin
üyelik	üye➊lik
üyesi	üye➊si
üyeliği	üye➊li➊ği
üyeliğine	üye➊li➊ği➊ne
üzere	üze➊re
üzerine	üze➊ri➊ne
üzerinde	üze➊rin➊de
üzerindeki	üze➊rin➊de➊ki
üzerinden	üze➊rin➊den
vadede	va➊de➊de
vadeli	va➊de➊li
var	var
vardı	var➊dı
varılan	va➊rı➊lan
varlığını	var➊lı➊ğı➊nı
vatandaşı	va➊tan➊da➊şı
vatandaşları	va➊tan➊daş➊la➊rı
vatandaşların	va➊tan➊daş➊la➊rın
vatandaşlarına	va➊tan➊daş➊la➊rı➊na
vatandaşlarının	va➊tan➊daş➊la➊rı➊nın
vatandaşlık	va➊tan➊daş➊lık
veda	ve➊da
verici	ve➊ri➊ci
veriyor	ve➊ri➊yor
veri	ve➊ri
verilecek	ve➊ri➊le➊cek
verilerine	ve➊ri➊le➊ri➊ne
verilen	ve➊ri➊len
veriliyor	ve➊ri➊li➊yor
verildi	ve➊ril➊di
verilmesi	ve➊ril➊me➊si
verilmesini	ve➊ril➊me➊si➊ni
veto	ve➊to
veya	ve➊ya
verdi	ver➊di
verecek	ve➊re➊cek
veren	ve➊ren
vergi	ver➊gi
verme	ver➊me
vermedi	ver➊me➊di
vermesi	ver➊me➊si
vermek	ver➊mek
vermeye	ver➊me➊ye
verdiği	ver➊di➊ği
verdiğini	ver➊di➊ği➊ni
vereceği	ve➊re➊ce➊ği
vereceğini	ve➊re➊ce➊ği➊ni
vermiş	ver➊miş
vermişti	ver➊miş➊ti
vestfalya	vest➊fal➊ya
video	vi➊de➊o
vize	vi➊ze
viktor	vik➊tor
vladimir	vla➊di➊mir
von	von
vurdu	vur➊du
vurgu	vur➊gu
vurgulayan	vur➊gu➊la➊yan
vurguluyor	vur➊gu➊lu➊yor
vurguladı	vur➊gu➊la➊dı
vurgulandı	vur➊gu➊lan➊dı
washington	wa➊shing➊ton
walter	wal➊ter
welle	wel➊le
welt	welt
westerwelle	wes➊ter➊wel➊le
wolfgang	wolf➊gang
yahudi	ya➊hu➊di
yana	ya➊na
yani	ya➊ni
yapacak	ya➊pa➊cak
yaparak	ya➊pa➊rak
yapan	ya➊pan
yaparken	ya➊par➊ken
yaratan	ya➊ra➊tan
yasa	ya➊sa
yasak	ya➊sak
yasal	ya➊sal
yazar	ya➊zar
yabancı	ya➊ban➊cı
yabancılar	ya➊ban➊cı➊lar
yabancıların	ya➊ban➊cı➊la➊rın
yakın	ya➊kın
yakında	ya➊kın➊da
yakından	ya➊kın➊dan
yakınlarında	ya➊kın➊la➊rın➊da
yakınlarındaki	ya➊kın➊la➊rın➊da➊ki
yaklaşık	yak➊la➊şık
yalnız	yal➊nız
yalnızca	yal➊nız➊ca
yandan	yan➊dan
yanı	ya➊nı
yanında	ya➊nın➊da
yanıt	ya➊nıt
yanıtı	ya➊nı➊tı
yanıtladı	ya➊nıt➊la➊dı
yankı	yan➊kı
yanlısı	yan➊lı➊sı
yanlış	yan➊lış
yapma	yap➊ma
yapmaya	yap➊ma➊ya
yapmak	yap➊mak
yapacağı	ya➊pa➊ca➊ğı
yapılacak	ya➊pı➊la➊cak
yapılan	ya➊pı➊lan
yapıldı	ya➊pıl➊dı
yapıldığı	ya➊pıl➊dı➊ğı
yapıldığını	ya➊pıl➊dı➊ğı➊nı
yapılıyor	ya➊pı➊lı➊yor
yapılması	ya➊pıl➊ma➊sı
yapılmasını	ya➊pıl➊ma➊sı➊nı
yapıyor	ya➊pı➊yor
yapması	yap➊ma➊sı
yapmayı	yap➊ma➊yı
yapmış	yap➊mış
yapmıştı	yap➊mış➊tı
yaptı	yap➊tı
yaptığı	yap➊tı➊ğı
yaptığını	yap➊tı➊ğı➊nı
yaptıkları	yap➊tık➊la➊rı
yaptırım	yap➊tı➊rım
yaptırımlar	yap➊tı➊rım➊lar
yaptırımların	yap➊tı➊rım➊la➊rın
yaralandı	ya➊ra➊lan➊dı
yaralandığı	ya➊ra➊lan➊dı➊ğı
yaralı	ya➊ra➊lı
yarattı	ya➊rat➊tı
yarattığı	ya➊rat➊tı➊ğı
yardım	yar➊dım
yardımcı	yar➊dım➊cı
yardımcısı	yar➊dım➊cı➊sı
yardımı	yar➊dı➊mı
yardımlar	yar➊dım➊lar
yardımların	yar➊dım➊la➊rın
yargı	yar➊gı
yarı	ya➊rı
yarım	ya➊rım
yarın	ya➊rın
yarısı	ya➊rı➊sı
yarışı	ya➊rı➊şı
yasadışı	ya➊sa➊dı➊şı
yasağı	ya➊sa➊ğı
yasanın	ya➊sa➊nın
yasası	ya➊sa➊sı
yaş	yaş
yaşadığı	ya➊şa➊dı➊ğı
yaşam	ya➊şam
yaşamını	ya➊şa➊mı➊nı
yaşanan	ya➊şa➊nan
yaşandı	ya➊şan➊dı
yaşandığı	ya➊şan➊dı➊ğı
yaşanıyor	ya➊şa➊nı➊yor
yaşayan	ya➊şa➊yan
yaşında	ya➊şın➊da
yaşındaki	ya➊şın➊da➊ki
yaşıyor	ya➊şı➊yor
yaşlı	yaş➊lı
yatırım	ya➊tı➊rım
yavaş	ya➊vaş
yaygın	yay➊gın
yayımlanan	ya➊yım➊la➊nan
yayın	ya➊yın
yayınladığı	ya➊yın➊la➊dı➊ğı
yayınlanan	ya➊yın➊la➊nan
yaz	yaz
yazdı	yaz➊dı
yazılı	ya➊zı➊lı
yazıyor	ya➊zı➊yor
yedi	ye➊di
yeni	ye➊ni
yeniden	ye➊ni➊den
yenilenebilir	ye➊ni➊le➊ne➊bi➊lir
yere	ye➊re
yerel	ye➊rel
yeri	ye➊ri
yerine	ye➊ri➊ne
yeterince	ye➊te➊rin➊ce
yeterli	ye➊ter➊li
yetersiz	ye➊ter➊siz
yer	yer
yerde	yer➊de
yerini	ye➊ri➊ni
yerinde	ye➊rin➊de
yerleşim	yer➊le➊şim
yeşil	ye➊şil
yeşiller	ye➊şil➊ler
yetkili	yet➊ki➊li
yetkilileri	yet➊ki➊li➊le➊ri
yetkililerin	yet➊ki➊li➊le➊rin
yetkililer	yet➊ki➊li➊ler
yetkilisi	yet➊ki➊li➊si
yıl	yıl
yıla	yı➊la
yılda	yıl➊da
yıldan	yıl➊dan
yıldır	yıl➊dır
yıldırım	yıl➊dı➊rım
yıldönümı	yıl➊dö➊nü➊mı
yılı	yı➊lı
yılın	yı➊lın
yılına	yı➊lı➊na
yılında	yı➊lın➊da
yılındaki	yı➊lın➊da➊ki
yılından	yı➊lın➊dan
yılının	yı➊lı➊nın
yılki	yıl➊ki
yıllar	yıl➊lar
yıllarca	yıl➊lar➊ca
yıllarda	yıl➊lar➊da
yıllardır	yıl➊lar➊dır
yılları	yıl➊la➊rı
yılların	yıl➊la➊rın
yıllık	yıl➊lık
yine	yi➊ne
yitirdi	yi➊tir➊di
yola	yo➊la
yolu	yo➊lu
yolunu	yo➊lu➊nu
yolunda	yo➊lun➊da
yoluyla	yo➊luy➊la
yoğun	yo➊ğun
yok	yok
yoksa	yok➊sa
yoksul	yok➊sul
yoksulluk	yok➊sul➊luk
yol	yol
yolcu	yol➊cu
yolda	yol➊da
yolsuzluk	yol➊suz➊luk
yorumlar	yo➊rum➊lar
yorumluyor	yo➊rum➊lu➊yor
york	york
yorumu	yo➊ru➊mu
yorumunda	yo➊ru➊mun➊da
yorum	yo➊rum
yorumda	yo➊rum➊da
yönelik	yö➊ne➊lik
yöneticisi	yö➊ne➊ti➊ci➊si
yönetimi	yö➊ne➊ti➊mi
yönetimine	yö➊ne➊ti➊mi➊ne
yönetimini	yö➊ne➊ti➊mi➊ni
yönetiminin	yö➊ne➊ti➊mi➊nin
yönetimin	yö➊ne➊ti➊min
yönetim	yö➊ne➊tim
yönetmen	yö➊net➊men
yönde	yön➊de
yönünde	yö➊nün➊de
yönündeki	yö➊nün➊de➊ki
yunanistan	yu➊na➊nis➊tan
yunanistan‘da	yu➊na➊nis➊tan➊‘➊da
yunanistan‘a	yu➊na➊nis➊tan➊‘➊a
yunan	yu➊nan
yunanistan‘ın	yu➊na➊nis➊tan➊‘➊ın
yunanistan‘ın	yu➊na➊nis➊tan➊‘➊ın
yurt	yurt
yüklü	yük➊lü
yüksek	yük➊sek
yükseldi	yük➊sel➊di
yüzünden	yü➊zün➊den
yük	yük
yürüten	yü➊rü➊ten
yürürlüğe	yü➊rür➊lü➊ğe
yürüttüğü	yü➊rüt➊tü➊ğü
yürütülen	yü➊rü➊tü➊len
yüz	yüz
yüzde	yüz➊de
yüzden	yüz➊den
yüzlerce	yüz➊ler➊ce
zafer	za➊fer
zamanlar	za➊man➊lar
zamanlarda	za➊man➊lar➊da
zaman	za➊man
zamanda	za➊man➊da
zarar	za➊rar
zaten	za➊ten
zamanı	za➊ma➊nı
zayıf	za➊yıf
zeitung	zei➊tung
zeitung‘un	zei➊tung➊‘➊un
zengin	zen➊gin
zenginleştirme	zen➊gin➊leş➊tir➊me
zira	zi➊ra
zirve	zir➊ve
zirvede	zir➊ve➊de
zirvenin	zir➊ve➊nin
zirvesi	zir➊ve➊si
zirvesinde	zir➊ve➊sin➊de
zirveye	zir➊ve➊ye
ziyade	zi➊ya➊de
ziyareti	zi➊ya➊re➊ti
ziyaret	zi➊ya➊ret
zor	zor
zorla	zor➊la
zorlu	zor➊lu
zorunda	zo➊run➊da
zorunlu	zo➊run➊lu
