Form	Pronunciation

# SPDX-License-Identifier: Unicode-DFS-2016

a	ɑ
aacht	aːχt
aachte	aːχtə
aachten	aːχtən
Aangel	aːŋəl
aangelkreepche	aːŋəlkʁeːpɕə
aangelkreepchen	aːŋəlkʁeːpɕən
Aarbecht	aːʁbəɕt
Aarbechter	aːʁbəɕtɐ
aarbechterinne	aːʁbəɕtəʁinə
aarbechtskolleeginne	aːʁbəɕt͡skoleːʑinə
Aarbechtskolleg	aːʁbəɕt͡skoleːɕ
aarbechtskolleginne	aːʁbəɕt͡skoleːʑinə
aarbechtslost	aːʁbəɕt͡sloːst
aarbechtsministär	aːʁbəɕt͡sministɛːʁ
Aarbechtsplaz	aːʁbəɕt͡splaːt͡s
Aarbechtszäit	aːʁbəɕt͡st͡sæːɪ̯t
aarm	aːʁm
Aarmbandauer	aːʁmbɑndɑʊ̯ɐ
aarme	aːʁmə
aarmséileg	aːʁmsɜɪ̯ləɕ
aarmutsituatiounen	aːʁmutzitwaːt͡sjəʊ̯nən
Aarmutsrisiko	aːʁmut͡sʁizikoː
Aarmutt	aːʁmut
Aart	aːʁt
aartlech	aːʁtləɕ
Aascht	aːʃt
Aaxt	aːkst
abatjour	ɑbaːʒuːʁ
Abattement	ɑbɑtəmɑ̃ː
abattemente	ɑbɑtəmɑ̃ːə
abattementen	ɑbɑtəmɑ̃ːən
Abberzuel	ɑbɐt͡suə̯l
ABC	aːbeːt͡seː
abee	ɑbeː
abegräife	ɑbəɡʁæːɪ̯fə
abegräifen	ɑbəɡʁæːɪ̯fən
Abendmahl	aːbəntmaːl
Abenteuer	aːbəntoɪɐ
abezuele	ɑbət͡suə̯lə
abezuelen	ɑbət͡suə̯lən
abgöttesch	ɑbɡøtəʃ
abiméiere	ɑbimɜɪ̯əʁə
abiméieren	ɑbimɜɪ̯əʁən
Abléck	ɑblek
abonnentinne	ɑbonæntinə
Abrëll	ɑbʁəl
Abrëllsgeck	ɑbʁəlsɡæk
abriecherinne	ɑbʁiə̯ɕəʁinə
Abroch	ɑbʁoχ
abscheilech	ɑpʃɑɪ̯ləɕ
absenteismus	ɑbzænteːismus
absichtlech	ɑpziɕtləɕ
absolutt	ɑpzolut
absolventinne	ɑbzolvæntinə
abstraéiert	ɑbstʁɑɜɪ̯ɐt
abstraéiertes	ɑbstʁɑɜɪ̯ɐtəs
abstrakt	ɑbstʁɑkt
absurd	ɑpzuʁt
äbtissinne	æptisinə
abus	ɑbyː
Abuse	ɑbyːə
Abusen	ɑbyːən
acceleratioun	ɑkseləʁɑt͡sjəʊ̯n
acceleratiounen	ɑksæləʁaːt͡sjəʊ̯nən
acceleréier	ɑkseləʁɜɪ̯ɐ
acceleréiere	ɑkseləʁɜɪ̯əʁə
accent	ɑksɑ̃ː
accentuéier	ɑksɑ̃ːtyɜɪ̯ɐ
accentuéiere	ɑksɑ̃ːtyɜɪ̯əʁə
accentuéieren	ɑksɑ̃ːtyɜɪ̯əʁən
accès	ɑksɛː
accèse	ɑksɛːə
accèsen	ɑksɛːən
accessibeles	ɑksæsibələs
accident	ɑksidænt
accisë	ɑksiːzə
Accisen	ɑksiːzən
accord	ɑkɔːʁ
accouchéiere	ɑkuʃɜɪ̯əʁə
accouchéieren	ɑkuʃɜɪ̯əʁən
Accouchement	ɑkuʃəmænt
accroc	ɑkʁoː
accueil	ɑkœj
accueile	ɑkœjə
accueilen	ɑkœjən
accumuléiere	ɑkymylɜɪ̯əʁə
accumuléieren	ɑkymylɜɪ̯əʁən
Achterbunn	ɑχtɐbun
achtkanteges	ɑχtkɑntəʑəs
achzeg	ɑχt͡səɕ
acompte	ɑkɑ̃ːnt
acomptë	ɑkɑ̃ːntə
acompten	ɑkɑ̃ːntən
acompter	ɑkɑ̃ːntɐ
acquis	ɑkiː
Acquise	ɑkiːə
Acquisen	ɑkiːən
acquisitioun	ɑkizit͡sjəʊ̯n
acquittéiere	ɑkitɜɪ̯əʁə
acteur	ɑktœːʁ
Acteure	ɑktœːʁə
actionnairinne	ɑksjoːnɛːʁinə
äddi	ædiː
äddie	ædiːə
äddien	ædiːən
adeleg	aːdələɕ
adelege	aːdələʑə
adequaatst	ɑdekwaːt͡st
adequaatste	ɑdekwaːt͡stə
adhésioun	ɑtheːzjəʊ̯n
Adjektiv	ɑtjektiːf
adjoint	ɑd͡ʒwɛ̃ː
adjointë	ɑd͡ʒwɛ̃ːə
adjointe	ɑd͡ʒwɛ̃ːnt
adjointeë	ɑd͡ʒwɛ̃ːntə
adjointeën	ɑd͡ʒwɛ̃ːntən
adjointen	ɑd͡ʒwɛ̃ːən
adjutant	ɑd͡ʒuːtɑnt
adjutante	ɑd͡ʒuːtɑntə
adjutanten	ɑd͡ʒuːtɑntən
adjutantin	ɑd͡ʒuːtɑntin
adjutantinne	ɑdjuːtɑntinə
adjutantinne	ɑd͡ʒuːtɑntinə
adjutantinnen	ɑd͡ʒuːtɑntinən
Adler	aːdlɐ
admirolinne	aːtmiʁoːlinə
Adolphe	ɑdolf
adoptéiere	ɑdoptɜɪ̯əʁə
adoptéieren	ɑdoptɜɪ̯əʁən
adoptiounsfamill	ɑdoptjəʊ̯nsfɑmil
adoptiounsfamille	ɑdoptjəʊ̯nsfɑmilə
adoptivjongen	ɑdoptiːfjoŋən
adoptivkand	ɑdoptiːfkɑnt
adoptivmamme	ɑdoptiːfmɑmə
Adress	ɑdʁæs
adressate	ɑdʁæsɑt
adresséiere	ɑdʁæsɜɪ̯əʁə
adresséieren	ɑdʁæsɜɪ̯əʁən
adriatesches	ɑdʁjaːtəʃəs
Adventskalenner	ɑdvænt͡skɑlænɐ
Ae	aːə
Aen	aːən
aendeckel	aːəndækəl
aendokter	aːəndoktɐ
äerd	ɛːɐt
Äerdbier	ɛːɐtbiɐ̯
Äerdbiewe	ɛːɐtbiə̯və
Äerdbiewen	ɛːɐtbiə̯vən
äerdeg	ɛːɐdəɕ
äerdejoer	ɛːɐdəjoːɐ
Aerobic	ɛːʁobik
aerodynamesch	ɛːʁoːdinaːməʃ
aerodynamik	aːəʁoːdinɑmik
äert	ɛːɐt
af	aːf
afaalt	ɑfaːlt
afalen	ɑfaːlən
Afe	aːfə
afeger	aːfəʑɐ
afegst	aːfəɕst
afegste	aːfəɕstə
afëllen	ɑfələn
afen	aːfən
Affär	ɑfɛːʁ
Affekot	ɑfəkoːt
affekotecabinet	ɑfəkoːtəkɑbineː
affekotinne	ɑfəkoːtinə
Affer	ɑfɐ
affere	ɑfəʁə
afferen	ɑfəʁən
Afferstack	ɑfɐʃtɑk
affichagë	ɑfiʃaːʒə
Affinitéit	ɑfinitɜɪ̯t
affirmativem	ɑfiʁmɑtiːvəm
affisch	ɑfiʃ
affischéiere	ɑfiʃɜɪ̯əʁə
affischéieren	ɑfiʃɜɪ̯əʁən
Afganistan	ɑfɡaːnistaːn
afoul	ɑfəʊ̯l
afoulen	ɑfəʊ̯lən
afouls	ɑfəʊ̯ls
afoult	ɑfəʊ̯lt
afüge	ɑfyːʑə
afügen	ɑfyːʑən
Agank	ɑɡɑŋk
agebaute	ɑɡəbæːʊ̯t
agebilt	ɑɡəbilt
agebilte	ɑɡəbiltə
agebilten	ɑɡəbiltən
Agebuerene	ɑɡəbuə̯ʁənə
agebuerenen	ɑɡəbuə̯ʁənən
agecheckt	ɑɡet͡ʃækt
agecheckte	ɑɡet͡ʃæktə
agechecktem	ɑɡet͡ʃæktəm
agenda	ɑʒændaː
agentinne	ɑɡæntinə
agestoe	ɑɡəʃtoːə
agestoen	ɑɡəʃtoːən
agoe	ɑɡoːə
agoen	ɑɡoːən
agréabel	ɑɡʁeaːbəl
agreabele	ɑɡʁeaːbələ
agreabelem	ɑɡʁeaːbələm
ähnlech	ɛːnləɕ
ahor	aːoːʁ
ahorn	aːhɔʁn
ahorne	aːhɔʁnə
aide	ɛːt
Aiden	ɛːdən
Aids	ɜɪ̯t͡s
äis	æːɪ̯s
äisbier	æːɪ̯sbiɐ̯
äiseg	æːɪ̯zəɕ
äisege	æːɪ̯zəʑə
äisegem	æːɪ̯zəʑəm
äisegen	æːɪ̯zəʑən
äiser	æːɪ̯zɐ
äiskal	æːɪ̯skaːl
äiskonschtleeferinne	æːɪ̯skonʃtleːfəʁinə
äisschongfuere	æːɪ̯sʃoŋfuə̯ʁə
äisschongfueren	æːɪ̯sʃoŋfuə̯ʁən
ajustéiere	ɑʒystɜɪ̯əʁə
ajustéieren	ɑʒystɜɪ̯əʁən
akachs	ɑkɑχs
akacht	ɑkɑχt
akademikerinne	ɑkaːdeːmikəʁinə
akaf	ɑkaːf
akafe	ɑkaːfə
akafen	ɑkaːfən
akafskuerf	ɑkaːfskuə̯f
akafsweenche	ɑkaːfsveːnɕə
akafsweenchen	ɑkaːfsveːnɕən
akaul	aːkɑʊ̯l
Akkord	ɑkɔχt
Akkorden	ɑkɔʁdən
Akkordeon	ɑkɔʁdeːɑ̃ː
akkordeone	ɑkɔʁdeːɑ̃ːə
akkordeonen	ɑkɔʁdeːɑ̃ːən
akkordeonistinne	ɑkoʁdeːonistinə
Akku	ɑkuː
akkue	ɑkuːə
Akkuen	ɑkuːən
aklamme	ɑklɑmə
aklammen	ɑklɑmən
aklemme	ɑklæmə
aklemmen	ɑklæmən
akrobat	ɑkʁoːbaːt
akrobat	ɑkʁobaːt
akrobate	ɑkʁoːbaːtə
Akrobaten	ɑkʁoːbaːtən
akrobatinne	ɑkʁoːbaːtinə
Akt	ɑkt
Aktie	ɑksjə
Aktien	ɑksjən
aktionärinne	ɑksjoːnɛːʁinə
Aktioun	ɑksjəʊ̯n
aktiv	ɑktiːf
aktiven	ɑktiːvən
aktiver	ɑktiːvɐ
aktivistinne	ɑktivistinə
Aktivitéit	ɑktivitɜɪ̯t
aktuell	ɑktwæl
al	aːl
aläert	ɑlɛːɐt
Alain	ɑlɛ̃ː
Alarm	ɑlɑʁm
album	ɑlbum
ale	aːlə
alen	aːlən
alertéiere	ɑlæʁtɜɪ̯əʁə
alertéieren	ɑlæʁtɜɪ̯əʁən
alg	ɑlɕ
alge	ɑlʑə
Algen	ɑlʑən
alibien	aːlibiːən
aliichte	ɑliːɕtə
aliichten	ɑliːɕtən
Alkohol	ɑlkohoːl
Alkohol	ɑlkohol
alkohole	ɑlkohoːlə
alkoholikerinne	ɑlkohoːlikəʁinə
all	ɑl
allebéid	ɑləbɜɪ̯t
alleguer	ɑləɡuɐ
Allergië	ɑlæʁʒiːə
Allergien	ɑlæʁʒiːən
Allerhellge	ɑlɐhælʑə
Allerhellgen	ɑlɐhælʑən
allerlee	ɑlɐleː
Allerséile	ɑlɐzɜɪ̯lə
Allerséilen	ɑlɐzɜɪ̯lən
alles	ɑləs
allgemeng	ɑlɡəmæŋ
Allianz	ɑljɑnt͡s
allianze	ɑljɑnt͡sə
Allianzen	ɑljɑnt͡sən
Alliéierten	ɑljɜɪ̯ɐtən
Alliéierter	ɑljɜɪ̯ɐtɐ
Allo	ɑloː
allür	ɑlyːʁ
allüre	ɑlyːʁ
allure	ɑlyːʁə
allurë	ɑlyːʁə
alluren	ɑlyːʁən
almose	ɑlmoːzə
almosen	ɑlmoːzən
almoudesch	aːlməʊ̯dəʃ
alpinistinne	ɑlpinistinə
als	ɑls
also	ɑlzoː
Alstad	aːlʃtaːt
alter	ɑltɐ
alternativ	ɑltɛɐnɑtiːf
altertum	ɑltɐtum
Altesse	ɑltæs
altessen	ɑltæsən
aluede	ɑluə̯də
alueden	ɑluə̯dən
Aluminium	ɑlyminjum
am	ɑm
amaache	ɑmaːχə
amaachen	ɑmaːχən
amaachglas	ɑmaːχɡlaːs
Amant	ɑmɑ̃ː
amante	ɑmɑ̃ːə
amanten	ɑmɑ̃ːən
amass	ɑmɑs
Amateur	ɑmɑtœːʁ
Ambassad	ɑmbɑsaːt
ambassadë	ɑ̃ːmbɑsaːdə
Ambassade	ɑ̃ːmbɑsaːt
Ambassaden	ɑ̃ːmbɑsaːdən
ambassadeur	ɑ̃ːmbɑsɑdœːʁ
ambigu	ɑ̃ːmbiɡyː
ambigue	ɑ̃ːmbiɡyːə
ambiguem	ɑ̃ːmbiɡyːəm
ambiguen	ɑ̃ːmbiɡyːən
ambiguitéit	ɑ̃ːmbiɡyːitɜɪ̯t
ambiguitéite	ɑ̃ːmbiɡyːitɜɪ̯t
ambiguitéiten	ɑ̃ːmbiɡyːitɜɪ̯tən
ambitiéis	ɑ̃ːmbisjɜɪ̯s
ambitiéise	ɑ̃ːmbisjɜɪ̯zə
Ambulanz	ɑmbulɑnt͡s
améchs	ɑməɕs
amelioratioun	ɑmeljoːʁɑt͡sjəʊ̯n
Amen	aːmən
amenagéiere	ɑmenaːʒɜɪ̯əʁə
amenagéieren	ɑmenaːʒɜɪ̯əʁən
amendéier	ɑmɑ̃ːndɜɪ̯ɐ
amendéieren	ɑmɑ̃ːndɜɪ̯əʁən
Amendement	ɑmɑ̃ːndəmɑ̃ː
ament	ɑmænt
Amerika	ɑmeːʁikaː
amësche	ɑməʃə
amëschen	ɑməʃən
ameséiere	ɑməzɜɪ̯əʁə
ameséieren	ɑməzɜɪ̯əʁən
amgaang	ɑmɡaːŋ
amicalle	ɑmikɑlə
amicallen	ɑmikɑlən
amnestie	ɑmnæstiː
amnestië	ɑmnæstiːə
Amok	ɑmok
amokleeferinne	ɑmokleːfəʁinə
amortiséiere	ɑmɔʁtizɜɪ̯əʁə
amortiséieren	ɑmɔʁtizɜɪ̯əʁən
amortisseur	ɑmɔʁtisœːʁ
amplaz	ɑmplaːt͡s
ampull	ɑmpul
amusant	ɑmuzɑnt
amusantem	ɑmuzɑntəm
amüsantem	ɑmysɑntəm
amüsantst	ɑmysɑnt͡st
amusantste	ɑmuzɑnt͡stə
Amusement	ɑmuzəmænt
an	ɑn
anachronismen	ɑnɑkʁonismən
analoger	ɑnaːloːʁɐ
Analogie	ɑnaːloːʒiː
analogië	ɑnaːloːʒiːə
analogië	ɑnaːloʒiːə
analogien	ɑnaːloːʒiːən
analoogt	ɑnaːloːχt
analphabet	ɑnɑlfaːbeːt
analphabete	ɑnɑlfaːbeːtə
Analphabeten	ɑnɑlfaːbeːtən
Analphabetin	ɑnaːlfaːbeːtin
analphabetinne	ɑnaːlfaːbətinə
analyse	ɑnaːliːzə
analytikerinne	ɑnaːlitikəʁinə
Ananas	ɑnɑnaːs
Anarchie	ɑnɑʁɕiə̯
anarchistinne	ɑnaːʁɕistinə
anäscheren	ɑnæʃəʁən
anästhesie	ɑnɛːsteːziː
anästhesië	ɑnɛːsteːziːə
anästhesistinne	ɑnɛːsteːsistinə
anchecken	ɑnt͡ʃækən
anchoisen	ɑ̃ːʃwɑən
Anekdot	ɑnækdoːt
aneneen	ɑnəneːn
aner	aːnɐ
anere	aːnəʁə
aneren	aːnəʁən
anescht	aːnəʃt
angab	ɑnɡaːp
Angabe	ɑnɡaːbə
angine	ɑ̃ːʒin
anginne	ɑ̃ːʒinə
Angscht	ɑŋʃt
ängschtlech	æŋʃtləɕ
Animateur	ɑnimɑtœːʁ
animéiere	ɑnimɜɪ̯əʁə
animéieren	ɑnimɜɪ̯əʁən
Anker	ɑŋkɐ
ännere	ænəʁə
änneren	ænəʁən
Ännerung	ænəʁuŋ
anniichter	ɑniːɕtɐ
anniversaire	ɑniːvæʁsɛːʁ
anniversairë	ɑniːvæʁsɛːʁə
Anniversairen	ɑniːvæʁsɛːʁən
annonce	ɑnɑ̃ːs
annoncéiere	ɑnɑ̃ːsɜɪ̯əʁə
annoncéieren	ɑnɑ̃ːsɜɪ̯əʁən
annuléiere	ɑnylɜɪ̯əʁə
annuléieren	ɑnylɜɪ̯əʁən
Anomalie	ɑnomaːliː
anomalië	ɑnomaːliːə
anonymmen	ɑnonimən
anorak	ɑnoʁɑk
anormal	ɑnɔʁmaːl
anotems	ɑnoːtəms
anotemt	ɑnoːtəmt
Antenn	ɑntæn
Antenne	ɑ̃ːntænə
Antennen	ɑ̃ːntænən
antëscht	ɑntəʃt
antibiotique	ɑntiːbjotik
antibiotiquë	ɑntiːbjotikə
antibiotiquen	ɑntiːbjotikən
anticke	ɑntikə
antickem	ɑntikəm
antik	ɑntiːk
antik	ɑntik
antikst	ɑntikst
antippe	ɑntipə
antippen	ɑntipən
antisemitesch	ɑntiːzeːmitəʃ
antisemitinne	ɑntiːzeːmitinə
antivol	ɑ̃ːntivol
antriichtere	ɑntʁiːɕtəʁə
antriichteren	ɑntʁiːɕtəʁən
äntwere	æntvəʁə
äntweren	æntvəʁən
äntwert	æntvɐt
anzeblende	ɑnt͡səblændə
anzeblenden	ɑnt͡səblændən
anzeblenne	ɑnt͡səblænə
anzeblennen	ɑnt͡səblænən
anzebrénge	ɑnt͡səbʁeŋə
anzebréngen	ɑnt͡səbʁeŋən
anzebrenne	ɑnt͡səbʁænə
anzesange	ɑnt͡səzɑŋə
anzwousch	ɑnt͡swəʊ̯ʃ
apaart	ɑpaːʁt
apake	ɑpaːkə
apaken	ɑpaːkən
Apdikt	ɑpdikt
Apdikter	ɑpdiktɐ
Apel	aːpəl
apendelen	ɑpəndələn
aperhoer	aːpɐhoːɐ
Apostel	ɑpostəl
apostele	ɑpostələ
Apostroph	ɑpostʁof
Apparat	ɑpɑʁaːt
Appartement	ɑpɑʁtəmænt
Äppelbam	æpəlbaːm
Äppeljus	æpəlʒyː
Appetit	ɑpətit
appetitlech	ɑpətitləɕ
Applaus	ɑplɑʊ̯s
approche	ɑpʁoʃ
approchë	ɑpʁoʃə
Approchen	ɑpʁoʃən
approuvéiere	ɑpʁuvɜɪ̯əʁə
approuvéieren	ɑpʁuvɜɪ̯əʁən
approximatiivt	ɑpʁoksimɑtiːft
approximativ	ɑpʁoksimɑtiːf
approximative	ɑpʁoksimaːtiːvə
appui	ɑpɥiː
apräägs	ɑpʁɛːɕs
aprägen	ɑpʁɛːʑən
aprikos	ɑpʁikoːs
Aquaplaning	ɑkwaːplaːniŋ
Aquarium	ɑkwaːʁium
äquator	eːkwaːtoːʁ
är	ɛːʁ
arabesch	ɑʁaːbəʃ
araume	ɑʁɑʊ̯mə
araumen	ɑʁɑʊ̯mən
Arbitter	ɑʁbitɐ
arbitterinne	ɑʁbitəʁinə
arcadë	ɑʁkaːdə
Arcade	ɑʁkaːt
arcaden	ɑʁkaːdən
archaesch	ɑʁkaːəʃ
archaeschen	ɑʁkaːəʃən
archeolog	ɑʁkeːoːloːk
archeologe	ɑʁkeːoːloːɡə
Archeologen	ɑʁkeːoːloːɡən
archeologinne	ɑʁkeːoːloːɡinə
Architekt	ɑʁʃitækt
architektinne	ɑʁɕitæktinə
Architektur	ɑʁɕitæktuːɐ
architekture	ɑʁɕitæktuːʁə
architekturen	ɑʁɕitæktuːʁən
Archiv	ɑʁɕiːf
Archive	ɑʁɕivə
archivistinne	ɑʁɕivistinə
äre	ɛːʁə
arem	aːʁəm
ären	ɛːʁən
arenne	ɑʁænə
arennen	ɑʁænən
ärer	ɛːʁɐ
ariichte	ɑʁiːɕtə
ariichten	ɑʁiːɕtən
aristokratinne	ɑʁistokʁaːtinə
Arméi	ɑʁmɜɪ̯
Arrêt	ɑʁɛː
arrêté	ɑʁeːteː
Arrête	ɑʁɛːə
arrêtéë	ɑʁeːteːə
Arrêtéen	ɑʁeːteːən
Arrêten	ɑʁɛːən
arrivée	ɑʁiveː
arrogant	ɑʁoːɡɑnt
arrogante	ɑʁoːɡɑntə
arterie	ɑʁteːʁjə
arterien	ɑʁteːʁjən
Arthrite	ɑʁtʁit
artichaut	ɑʁtiʃoː
Artikel	ɑʁtikəl
artist	ɑʁtist
artisteschste	ɑʁtistəʃstə
artisteschstem	ɑʁtistəʃstəm
artisteschsten	ɑʁtistəʃstən
artisteschster	ɑʁtistəʃstɐ
artistinne	ɑʁtistinə
asammele	ɑzɑmələ
asammelen	ɑzɑmələn
asazfäegster	ɑzaːt͡sfɛːəɕstɐ
asazfäegt	ɑzaːt͡sfɛːəɕt
asazfäheg	ɑzaːt͡sfɛːəɕ
Äsche	æʃə
äschebecher	æʃəbæɕɐ
Äschen	æʃən
äschenteller	æʃəntælɐ
aschloe	ɑʃloːə
aschloen	ɑʃloːən
aschlofe	ɑʃloːfə
aschlofen	ɑʃloːfən
aspaans	ɑʃpaːns
aspaant	ɑʃpaːnt
aspäre	ɑʃpɛːʁə
aspären	ɑʃpɛːʁən
Aspekt	ɑspækt
Aspro	ɑspʁoː
assistentinne	ɑsistæntinə
assitant	ɑsistɑ̃ː
Associé	ɑsosieː
associée	ɑsosjeː
associéë	ɑsosjeːə
associéeë	ɑsosjeːə
associéeën	ɑsosjeːən
Assurance	ɑsyʁɑ̃ːs
assuréiere	ɑsyʁɜɪ̯əʁə
assuréieren	ɑsyʁɜɪ̯əʁən
astéings	ɑʃtɜɪ̯ŋs
astéingt	ɑʃtɜɪ̯ŋt
astelle	ɑʃtælə
astellen	ɑʃtælən
ästhet	æsteːt
Asthma	ɑstmaː
astouch	ɑʃtəʊ̯χ
astoungen	ɑʃtəʊ̯ŋən
astoungs	ɑʃtəʊ̯ŋs
astrolog	ɑstʁoloːχ
astrologe	ɑstʁoloːʁə
astrologen	ɑstʁoloːʁən
astrologinne	ɑstʁoloːɡinə
Astronaut	ɑstʁonɑʊ̯t
astronautinne	ɑstʁonɑʊ̯tinə
asylantinne	ɑsilɑntinə
atelier	ɑtəlieː
atelier	ɑtəljeː
Ateliere	ɑtəljeːə
atheistinne	ɑteːistinə
athlet	ɑtleːt
athletinne	ɑtleːtinə
Atlas	ɑtlɑs
Atom	ɑtoːm
Atomreakter	ɑtoːmʁeɑktɐ
atoute	ɑtuːə
Atouten	ɑtuːən
Attentat	ɑtəntaːt
Attentater	ɑtəntaːtɐ
attentäterinne	ɑtɑ̃ːtɛːtəʁinə
atter	ɑtɐ
Attitude	ɑtityːt
attitudë	ɑtitydə
Attraktioun	ɑtʁɑksjəʊ̯n
aubergine	oːbɛʁʒin
auberginne	oːbɛʁʒinə
auder	ɑʊ̯dɐ
Audienz	ɑʊ̯djænt͡s
audienze	ɑʊ̯djænt͡sə
audiovisuell	ɑʊ̯djoːviːzwæl
Auditoire	oːditwaːʁ
auditoirë	oːditwaːʁə
auer	ɑʊ̯ɐ
auermécher	ɑʊ̯ɐməɕɐ
Aufgab	ɑʊ̯fɡaːp
Aufsatz	ɑʊ̯fsɑt͡s
August	ɑʊ̯ɡust
aus	æːʊ̯s
ausbaue	æːʊ̯sbɑʊ̯ə
ausbauen	æːʊ̯sbɑʊ̯ən
ausbehale	æːʊ̯sbəhaːlə
ausbehalen	æːʊ̯sbəhaːlən
ausdeele	æːʊ̯sdeːlə
ausdeelen	æːʊ̯sdeːlən
ausdoe	æːʊ̯sdoːə
ausdoen	æːʊ̯sdoːən
ausdrécke	æːʊ̯sdʁekə
ausdrécken	æːʊ̯sdʁekən
Ausdrock	æːʊ̯sdʁok
auserhéngert	æːʊ̯zɐheŋɐt
ausernee	æːʊ̯zɐneː
auserneen	æːʊ̯zɐneːn
ausféiere	æːʊ̯sfɜɪ̯əʁə
ausféieren	æːʊ̯sfɜɪ̯əʁən
ausfëlle	æːʊ̯sfələ
ausfëllen	æːʊ̯sfələn
Ausflug	æːʊ̯sfluχ
Ausgab	æːʊ̯sɡaːp
ausgebeut	æːʊ̯sɡəboɪt
ausgebeute	æːʊ̯sɡəboɪtə
ausgerechent	æːʊ̯sɡəʁæɕənt
ausgesinn	æːʊ̯sɡəzin
ausginn	æːʊ̯sɡin
ausgoe	æːʊ̯sɡoːə
ausgoen	æːʊ̯sɡoːən
aushéngere	æːʊ̯sheŋəʁə
aushéngeren	æːʊ̯sheŋəʁən
aushoul	æːʊ̯shəʊ̯l
aushoulen	æːʊ̯shəʊ̯lən
aushouls	æːʊ̯shəʊ̯ls
aushoult	æːʊ̯shəʊ̯lt
aushoung	æːʊ̯shəʊ̯ŋ
aushoungen	æːʊ̯shəʊ̯ŋən
auskräischs	æːʊ̯skʁæːɪ̯ʃs
auslafe	æːʊ̯slaːfə
auslafen	æːʊ̯slaːfən
Ausland	æːʊ̯slɑnt
Auslänner	æːʊ̯slænɐ
Auslännerinne	æːʊ̯slænəʁinə
auslännesch	æːʊ̯slænəʃ
auslous	æːʊ̯sləʊ̯s
auslouse	æːʊ̯sləʊ̯s
auslousen	æːʊ̯sləʊ̯zən
ausloust	æːʊ̯sləʊ̯st
ausluede	æːʊ̯sluə̯də
auslueden	æːʊ̯sluə̯dən
ausmaache	æːʊ̯smaːχə
ausmaachen	æːʊ̯smaːχən
Ausnahm	æːʊ̯snaːm
ausnotze	æːʊ̯snot͡sə
ausnotzen	æːʊ̯snot͡sən
auspäife	æːʊ̯spæːɪ̯fə
auspäifen	æːʊ̯spæːɪ̯fən
auspéile	æːʊ̯spɜɪ̯lə
auspéilen	æːʊ̯spɜɪ̯lən
Auspuff	æːʊ̯spuf
ausraibere	æːʊ̯sʁɑɪ̯bəʁə
ausraiberen	æːʊ̯sʁɑɪ̯bəʁən
ausraume	æːʊ̯sʁɑʊ̯mə
ausraumen	æːʊ̯sʁɑʊ̯mən
ausrechne	æːʊ̯sʁæɕnə
ausrechnen	æːʊ̯sʁæɕnən
ausrësele	æːʊ̯sʁəzələ
ausrëselen	æːʊ̯sʁəzələn
ausrësserinne	æːʊ̯sʁəsəʁinə
ausriede	æːʊ̯sʁiə̯də
Ausrieden	æːʊ̯sʁiə̯dən
ausrifferinne	æːʊ̯sʁifəʁinə
ausroue	æːʊ̯sʁəʊ̯ə
ausrouen	æːʊ̯sʁəʊ̯ən
ausrutsche	æːʊ̯sʁut͡ʃə
ausrutschen	æːʊ̯sʁut͡ʃən
ausschëdde	æːʊ̯sʃədə
ausschëdden	æːʊ̯sʃədən
ausschlaggebend	æːʊ̯sʃlaːχɡeːbənt
ausschlaggebende	æːʊ̯sʃlaːχɡeːbəndə
ausschlaggebendem	æːʊ̯sʃlaːχɡeːbəndəm
ausschlaggebenden	æːʊ̯sʃlaːχɡeːbəndən
ausschlofe	æːʊ̯sʃloːfe
ausschlofen	æːʊ̯sʃloːfen
Ausschnëtt	æːʊ̯sʃnət
ausseministerinne	æːʊ̯səministəʁinə
ausser	æːʊ̯sɐ
aussergewéinlech	æːʊ̯sɐɡəvɜɪ̯nləɕ
äusserlech	oɪsɐləɕ
ausseruerdentlech	æːʊ̯sɐuɐdəntləɕ
ausseruerdentleche	æːʊ̯sɐuɐdəntləɕə
ausseruerdentlechem	æːʊ̯sɐuɐdəntləɕəm
ausseruerdentlechen	æːʊ̯sɐuɐdəntləɕən
ausseruerdentlecher	æːʊ̯sɐuɐdəntləɕɐ
ausseruerdentlechst	æːʊ̯sɐuɐdəntləɕst
äusserung	oɪsɐʁuŋ
aussesäiterinne	æːʊ̯szəzæːɪ̯təʁinə
Ausso	æːʊ̯szoː
ausspane	æːʊ̯sʃpaːnə
ausspanen	æːʊ̯sʃpaːnən
aussprieche	æːʊ̯sʃpʁiə̯ɕə
ausspriechen	æːʊ̯sʃpʁiə̯ɕən
Aussprooch	æːʊ̯sʃpʁoːχ
ausstelle	æːʊ̯sʃtælə
ausstellen	æːʊ̯sʃtælən
ausstellerinne	æːʊ̯sʃtæləʁinə
Ausstellung	æːʊ̯sʃtæluŋ
Ausstierwe	æːʊ̯sʃtiə̯və
ausstierwen	æːʊ̯sʃtiə̯vən
auswäiche	æːʊ̯svæːɪ̯ɕə
auswäichen	æːʊ̯svæːɪ̯ɕən
auswanderinne	æːʊ̯svɑndəʁinə
auswenneg	æːʊ̯svænəɕ
auswësche	æːʊ̯svəʃə
auswëschen	æːʊ̯svəʃən
Auswiel	æːʊ̯sviə̯l
auszedoe	æːʊ̯st͡sədoːə
auszepake	æːʊ̯st͡səpaːkə
autant	oːtɑ̃ː
auteur	oːtœːʁ
auto	ɑʊ̯toː
Autobunn	ɑʊ̯toːbun
autobunnssortie	ɑʊ̯toːbunssɔʁtiː
Autofuerer	ɑʊ̯toːfuə̯ʁɐ
automobilistinne	ɑʊ̯toːmobilistinə
autorinne	ɑʊ̯toːʁinə
Avancen	ɑvɑ̃ːsən
Avantage	ɑvɑ̃ːtaːʃ
avenue	ɑvənyː
avenuen	ɑvənyːən
averstan	ɑfɐʃtaːn
avertéieren	ɑvæʁtɜɪ̯əʁən
avertéiers	ɑvæʁtɜɪ̯ɐs
avis	ɑviː
Avise	ɑviːə
Avisen	ɑviːən
awanderinne	ɑvɑndəʁinə
awar	ɑvaːʁ
aweeche	ɑveːɕə
aweechen	ɑveːɕən
aweie	ɑvɑɪ̯ə
aweien	ɑvɑɪ̯ən
awëllege	ɑvələʑə
awëllegen	ɑvələʑən
awëllegung	ɑvələʑuŋ
awer	aːvɐ
awerglaf	aːvɐɡlaːf
Awuer	ɑvuɐ
Awunner	ɑvunɐ
awunnerinne	ɑvunəʁinə
Baach	baːχ
baang	baːŋ
baarbes	baːʁbəs
baarf	baːʁf
Baarmhäerzegkeet	baːʁmhɛːɐt͡səɕkeːt
Baart	baːʁt
baartbiischt	baːʁtbiːʃt
baasch	baːʃ
babbele	bɑbələ
babbelen	bɑbələn
babysitterinne	bɑbiːsitəʁinə
Bäcker	bækɐ
Bäckerei	bækəʁɑɪ̯
bäckesch	bækəʃ
bad	baːt
badgë	bæd͡ʒə
Badge	bæt͡ʃ
badgen	bæd͡ʒən
baffe	bɑfə
baffen	bɑfən
Bagage	bɑɡaːʃ
Bagger	bɑɡɐ
bäichelche	bæːɪ̯ɕəlɕə
Bäichelchen	bæːɪ̯ɕəlɕən
baichelcher	bɑɪ̯ɕəlɕɐ
bäiginn	bæːɪ̯ɡin
bäigoe	bæːɪ̯ɡoːə
bäigoen	bæːɪ̯ɡoːən
bäilafe	bæːɪ̯laːfə
bäilafen	bæːɪ̯laːfən
bäilagen	bæːɪ̯laːʁən
Bäileed	bæːɪ̯leːt
bäiluegt	bæːɪ̯luə̯ɕt
bäisse	bæːɪ̯sə
baisse	bæs
bäissen	bæːɪ̯sən
bäiwunne	bæːɪ̯vunə
bäiwunnen	bæːɪ̯vunən
Bak	baːk
Bake	baːkə
baken	baːkən
bakzant	baːkt͡sɑnt
bal	baːl
Balkon	bɑlkɑ̃ː
Ball	bɑl
Ballet	bɑleː
Ballon	bɑlɑ̃ː
balucke	bɑlukə
balucken	bɑlukən
Bam	baːm
bampele	bɑmpələ
bampelen	bɑmpələn
Bamstamm	baːmʃtɑm
banal	bɑnaːl
banane	bɑnɑn
band	bɑnt
bandage	bɑndaːʃ
banditinne	bɑnditinə
Bänk	bæŋk
bank	bɑŋk
Bänke	bæŋkə
Banke	bɑŋkə
Bänken	bæŋkən
Banken	bɑŋkən
bankerinne	bæŋkəʁinə
banne	bɑnə
bannen	bɑnən
bannendes	bɑnəndəs
Bannenhaff	bɑnənhɑf
Bänner	bænɐ
baroninne	bɑʁoːninə
Barrage	bɑʁaːʃ
Barrière	bɑʁiɛːʁ
bascht	bɑʃt
baschte	bɑʃtə
baschten	bɑʃtən
Basis	baːzis
basketspillerinne	bɑskæt͡ʃpiləʁinə
baskett	bɑskæt
bass	bɑs
bassistinne	bɑsistinə
bastele	bɑstələ
bastelen	bɑstələn
bastlerinne	bɑstləʁinə
bataklang	bɑtɑklɑŋ
batter	bɑtɐ
Batterie	bɑtəʁiː
bätz	bæt͡s
Batz	bɑt͡s
Bau	bæːʊ̯
bauaarbechterinne	bɑʊ̯aːʁbəɕtəʁinə
Bauch	bæːʊ̯χ
baue	bɑʊ̯ə
bauen	bɑʊ̯ən
Bauer	bɑʊ̯ɐ
Bauerenhaff	bɑʊ̯əʁənhɑf
baufälleg	bæːʊ̯fæləɕ
baukaste	bɑʊ̯kɑstə
baukasten	bɑʊ̯kɑstən
baupse	bɑʊ̯psə
baupsen	bɑʊ̯psən
bauscheg	bæːʊ̯ʃəɕ
bausse	bæːʊ̯sə
baussen	bæːʊ̯sən
beaaften	bəaːftən
beaarbecht	bəaːʁbəɕt
beaarbechte	bəaːʁbəɕtə
beafe	bəaːfə
beafloss	bəɑflos
beamt	biːmt
Beamte	bəɑmtə
beamtebeleidegung	bəɑmtəbəlɑɪ̯dəʑuŋ
Beamten	bəɑmtən
beandrock	bəɑndʁok
beandrocke	bəɑndʁokə
beängschtegend	bəæŋʃtəʑənt
beäntwer	bəæntvɐ
beäntwere	bəæntvəʁə
Beauté	boːteː
Becher	bæɕɐ
Béchs	beks
béchse	beksə
béchsefleesch	beksəfleːʃ
béchsen	beksən
béchsenöffner	beksənœfnɐ
bécke	bekə
bécken	bekən
bedauere	bədɑʊ̯əʁə
bedaueren	bədɑʊ̯əʁən
bedauerlech	bədɑʊ̯ɐləɕ
bedeite	bədɑɪ̯tə
bedeiten	bədɑɪ̯tən
bedeitend	bədɑɪ̯tənt
Bedierfnesser	bədiɐ̯fnəsɐ
bedrécke	bədʁekə
bedrécken	bədʁekən
bedreckse	bədʁæksə
bedrecksen	bədʁæksən
bedupse	bədupsə
bedupsen	bədupsən
Bee	beː
beeme	beːmə
beemen	beːmən
been	beːn
Bees	beːs
Beesen	beːsən
befriddegend	bəfʁidəʑənt
begaabt	bəɡaːpt
begeeschtert	bəɡeːʃtɐt
Begeeschterung	bəɡeːʃtəʁuŋ
begéine	bəɡɜɪ̯nə
begéinen	bəɡɜɪ̯nən
begleede	bəɡleːdə
begleeden	bəɡleːdən
begradegen	bəɡʁaːdəʑən
begräife	bəɡʁæːɪ̯fə
begräifen	bəɡʁæːɪ̯fən
begréisse	bəɡʁɜɪ̯sə
begréissen	bəɡʁɜɪ̯sən
Begréissung	bəɡʁɜɪ̯suŋ
Begriefnes	bəɡʁiə̯fnəs
begruewe	bəɡʁuə̯və
begruewen	bəɡʁuə̯vən
behaapte	bəhaːptə
behaapten	bəhaːptən
behandele	bəhɑndələ
behandelen	bəhɑndələn
behenn	bəhæn
behuele	bəhuə̯lə
behuelen	bəhuə̯lən
bei	bɑɪ̯
béie	bɜɪ̯ə
beiekinniginne	bɑɪ̯əkiniɡinə
béien	bɜɪ̯ən
beienee	bɑɪ̯əneː
beieneen	bɑɪ̯əneːn
beienziichterinne	bɑɪ̯ənt͡siːɕtəʁinə
Béier	bɜɪ̯ɐ
beiestack	bɑɪ̯əʃtɑk
beifall	bɑɪ̯fɑl
beige	bɛːʃ
beil	bɑɪ̯l
beim	bɑɪ̯m
béis	bɜɪ̯s
Beispill	bɑɪ̯ʃpil
bejoe	bəjoːə
bejoen	bəjoːən
bekannt	bəkɑnt
bekannte	bəkɑntə
bekannten	bəkɑntən
Bekanntschaft	bəkɑnt͡ʃɑft
bekäppe	bəkæpə
bekäppen	bəkæpən
bekéierunge	bəkɜɪ̯əʁuŋə
bekloe	bəkloːə
bekloen	bəkloːən
bekucke	bəkukə
bekucken	bəkukən
belagere	bəlaːɡəʁə
belageren	bəlaːɡəʁən
belästege	bəlæstəʑə
belästegen	bəlæstəʑən
beléie	bəlɜɪ̯ə
beléien	bəlɜɪ̯ən
belibeg	bəliːbəɕ
beliichte	bəliːɕtə
beliichten	bəliːɕtən
Beliichtung	bəliːɕtuŋ
bëlleg	bələɕ
beloune	bələʊ̯nə
belounen	bələʊ̯nən
Belounung	bələʊ̯nuŋ
belsch	bælʃ
bemustere	bəmustəʁə
bemusteren	bəmustəʁən
bëndelche	bəndəlɕə
bëndelchen	bəndəlɕən
beneiden	bənɑɪ̯dən
benevol	benevol
Bengel	bæŋəl
beniwwelen	bənivələn
benotze	bənot͡sə
benotzen	bənot͡sən
benotzerinne	bənot͡səʁinə
benotzerrotschlag	bənot͡sɐʁoːt͡ʃlaːχ
Bensin	bænzin
bensinspompel	bænzinspompəl
Bensinsstatioun	bænzinsʃtaːt͡sjəʊ̯n
berappe	bəʁɑpə
berappen	bəʁɑpən
berechne	bəʁæɕnə
berechnen	bəʁæɕnən
Berechnung	bəʁæɕnuŋ
beréiere	bəʁɜɪ̯əʁə
beréieren	bəʁɜɪ̯əʁən
berode	bəʁoːdə
beroden	bəʁoːdən
beroderinne	bəʁoːdəʁinə
berouege	bəʁəʊ̯əʑə
berouegen	bəʁəʊ̯əʑən
Berouegungsmëttel	bəʁəʊ̯əʑuŋsmətəl
Berri	bæʁiː
beruff	bəʁuf
beruffsgrupp	bəʁufsɡʁup
berühmt	bəʁyːmt
besat	bəsaːt
Bësch	bəʃ
bëschaarbechterinne	bəʃaːʁbəɕtəʁinə
beschäftegungssommet	bəʃæftəʑuŋssomeː
Beschass	bəʃɑs
bescheed	bəʃeːt
bescheide	bəʃɑɪ̯də
bescheiden	bəʃɑɪ̯dən
bescheinege	bəʃɑɪ̯nəʑə
bescheinegen	bəʃɑɪ̯nəʑən
beschëllege	bəʃələʑə
beschëllegen	bəʃələʑən
beschiedege	bəʃiə̯dəʑə
beschiedegen	bəʃiə̯dəʑən
beschmiere	bəʃmiə̯ʁə
beschmieren	bəʃmiə̯ʁən
Bëschof	bəʃoːf
beschrëftung	bəʃʁəftuŋ
beschreiwe	bəʃʁɑɪ̯və
beschreiwen	bəʃʁɑɪ̯vən
Beschreiwung	bəʃʁɑɪ̯vuŋ
beschte	bæʃtə
beschten	bæʃtən
beschütze	bəʃyt͡sə
beschützen	bəʃyt͡sən
beschwéiere	bəʃwɜɪ̯əʁə
beschwéieren	bəʃwɜɪ̯əʁən
bëschzerstéierung	bəʃt͡sɐʃtɜɪ̯əʁuŋ
bësele	bəzələ
bëselen	bəzələn
besetze	bəzæt͡sə
besetzen	bəzæt͡sən
Besëtzer	bəzət͡sɐ
besëtzerinne	bəzət͡səʁinə
besiche	bəziɕə
besichen	bəziɕən
besoff	bəzof
besoin	bəzwɛ̃ː
besonnesch	bəzonəʃ
bësse	bəsə
bëssen	bəsən
besser	bæsɐ
besserer	bæsəʁɐ
besseres	bæsəʁəs
Besserung	bæsəʁuŋ
besserwësserinne	bæsɐvəsəʁinə
bestelle	bəʃtælə
bestellen	bəʃtælən
Bestellung	bəʃtæluŋ
bestëmmt	bəʃtəmt
bestierzung	bəʃtiɐ̯t͡suŋ
Bestietnes	bəʃtiə̯tnəs
bestoe	bəʃtoːə
bestoen	bəʃtoːən
bestrofe	bəʃtʁoːfə
bestrofen	bəʃtʁoːfən
Bestseller	bæst͡sælɐ
bestuede	bəʃtuə̯də
bestueden	bəʃtuə̯dən
bestuet	bəʃtuə̯t
Besuch	bəzuχ
besuddele	bəzudələ
besuddelen	bəzudələn
betaaschte	bətaːʃtə
betaaschten	bətaːʃtən
Bëtong	bətoŋ
betoune	bətəʊ̯nə
betounen	bətəʊ̯nən
Betounung	bətəʊ̯nuŋ
Betrib	bətʁiːp
Bett	bæt
bettduch	bætduχ
bettseecheschzalot	bætzeːʃəʃt͡sɑloːt
bettspree	bæt͡ʃpʁeː
bevëlkere	bəvəlkəʁə
Bewäertungssystem	bəvɛːɐtuŋssisteːm
Bewäis	bəvæːɪ̯s
bewässere	bəvæsəʁə
bewässeren	bəvæsəʁən
bewege	bəveːʑə
bewegen	bəveːʑən
beweise	bəvɑɪ̯zə
beweisen	bəvɑɪ̯zən
bewëllege	bəvələʑə
bewëllegen	bəvələʑən
bewonnere	bəvonəʁə
bewonneren	bəvonəʁən
bewonnereswäert	bəvonəʁəsvɛːɐt
Bewonnerung	bəvonəʁuŋ
bewosstlosegkeet	bəvostloːzəɕkeːt
bezéiungsproblem	bət͡sɜɪ̯uŋspʁobleːm
bezuele	bət͡suə̯lə
bezuelen	bət͡suə̯lən
bibeltext	bibəltækst
Biber	biːbɐ
bibliothecairinne	biblioteːkɛːʁinə
Bibliothéik	bibliotɜɪ̯k
Bic	bik
bich	biɕ
Bichelche	biɕəlɕə
Bichelchen	biɕəlɕən
Bicherbuttek	biɕɐbutek
Bicherschaf	biɕɐʃaːf
bidde	bidə
bidden	bidən
biddo	bidoː
bidet	bideː
biede	biə̯də
bieden	biə̯dən
biegerinitiativ	bieːʑɐinit͡sjɑtiːf
Bier	biɐ̯
Bierg	biɐ̯ɕ
biergaarbechterinne	biɐ̯ɕaːʁbəɕtəʁinə
Bierger	biɐ̯ʑɐ
biergerinne	biɐ̯ʑəʁinə
biergsteigerinne	biɐ̯ɕʃtɑɪ̯ʑəʁinə
Bierk	biɐ̯k
Biesem	biə̯zəm
biffdeck	bifdæk
bigoudi	biɡudiː
Biischt	biːʃt
Bijou	biʒuː
Bijouterie	biʒuːtəʁiː
bild	bilt
bildungschaos	bilduŋskaːos
Bille	bilə
billen	bilən
Biller	bilɐ
Billerbuch	bilɐbuχ
Billjee	biljeː
Bir	biɐ̯
birele	biːʁələ
birelen	biːʁələn
bis	bis
Bistro	bistʁoː
bitze	bit͡sə
bitzen	bit͡sən
bitzmaschinne	bit͡smɑʃinə
biz	biːt͡s
Bläi	blæːɪ̯
Bläistëft	blæːɪ̯ʃtəft
bläizaldot	blæːɪ̯t͡sɑldoːt
blaméiere	blɑmɜɪ̯əʁə
blaméieren	blɑmɜɪ̯əʁən
blann	blɑn
bläre	blɛːʁə
blären	blɛːʁən
Blat	blaːt
blatzeg	blɑt͡səɕ
Blech	blæɕ
blechschléier	bləɕʃlɜɪ̯ɐ
Bléck	blek
bleech	bleːɕ
Bléi	blɜɪ̯
bléie	blɜɪ̯ə
bléien	blɜɪ̯ən
bléimele	bleːimələ
bléimelen	bleːimələn
bleiwe	blɑɪ̯və
bleiwen	blɑɪ̯vən
blénke	bleŋkə
blénken	bleŋkən
bless	blæs
blesséiere	blæsɜɪ̯əʁə
blesséieren	blæsɜɪ̯əʁən
blesséierte	blæsɜɪ̯ɐtə
blesséierten	blæsɜɪ̯ɐtən
Blëtz	blət͡s
blëtze	blət͡sə
blëtzen	blət͡sən
blo	bloː
block	blok
blöd	bløːt
bloder	bloːdɐ
bloelzeg	bloːəlt͡səɕ
blond	blont
Blos	bloːs
blose	bloːzə
blosen	bloːzən
Blouse	bluːs
bludde	bludə
bludden	bludən
Bluddung	bluduŋ
Blumm	blum
blummebeet	bluməbeːt
blummebuttek	bluməbutek
Blummendëppe	bluməndəpə
Blummendëppen	bluməndəpən
blus	bluːs
Blutt	blut
bluttaarmutt	bludaːʁmut
Bluttdrock	blutdʁok
Bobine	bobin
bobinne	bobinə
Bockel	bokəl
bockeleg	bokələɕ
bockeleges	bokəleɡəs
bocksprange	bokʃpʁɑŋə
bocksprangen	bokʃpʁɑŋən
bokal	bokaːl
Boll	bol
Bols	bols
Boma	boːmaː
bomen	boːmən
bomercher	boːmɐɕɐ
Bomi	boːmi
Bomien	boːmiːən
Bomm	bom
bompele	bompələ
bompelen	bompələn
bon	bɑ̃ː
Bongert	boŋɐt
Boni	boːni
bonjour	bɑ̃ːʒuːɐ
bonsoir	bɑ̃ːswaːʁ
bonusse	boːnusə
bonzele	bont͡sələ
bonzelen	bont͡sələn
Boot	boːt
Bopa	boːpaː
bor	boːʁ
bord	bɔːʁ
bordüre	bɔʁdyːʁ
borem	boːʁəm
bosnesch	bosnəʃ
bosseg	bosəɕ
botanikerinne	botaːnikəʁinə
Botte	bot
Botter	botɐ
Botz	bot͡s
botze	bot͡sə
botzen	bot͡sən
Botzerei	bot͡səʁɑɪ̯
Botzfra	bot͡sfʁaː
Bou	bəʊ̯
bouaker	bəʊ̯aːkɐ
Bouf	bəʊ̯f
bougie	buʒiː
boule	bul
boulette	bulæt
Boun	bəʊ̯n
Bouquet	bukeː
bouschéisse	bəʊ̯ʃɜɪ̯sə
Bouschéissen	bəʊ̯ʃɜɪ̯sən
Bouss	bəʊ̯s
Boutique	butik
boutiquë	butikə
box	boks
Boxe	boksə
boxen	boksən
boxerinne	boksəʁinə
boycott	boɪkot
braavst	bʁaːfst
braderië	bʁɑdeʁiːə
braderieen	bʁɑdeʁiːən
Bräiläffel	bʁæːɪ̯læfəl
Bräitchemann	bʁæːɪ̯t͡ɕəmɑn
Brak	bʁaːk
brand	bʁɑnt
brandwonn	bʁɑntvon
Branntewäin	bʁɑntəvæːɪ̯n
brasseli	bʁɑsəli
bratzele	bʁɑt͡səle
bratzelen	bʁɑt͡səlen
brauch	bʁæːʊ̯χ
brauche	bʁæːʊ̯χə
brauchen	bʁæːʊ̯χən
brauereisecteur	bʁɑʊ̯əʁɑɪ̯sæktœːʁ
brauereispäerd	bʁɑʊ̯əʁɑɪ̯spɛːɐt
braumeeschterinne	bʁæːʊ̯meːʃtəʁinə
braut	bʁæːʊ̯t
brautrank	bʁæːʊ̯tʁɑŋk
brav	bʁaːf
braven	bʁaːvən
braver	bʁaːvɐ
bravo	bʁaːvoː
Bréck	bʁek
breet	bʁeːt
bréie	bʁɜɪ̯ə
bréien	bʁɜɪ̯ən
Bréif	bʁɜɪ̯f
Bréifboîte	bʁɜɪ̯fbwɑt
Bréifdréier	bʁɜɪ̯fdʁɜɪ̯ɐ
Bréifkëscht	bʁɜɪ̯fkəʃt
Bréitche	bʁɜɪ̯t͡ɕə
Bréitchen	bʁɜɪ̯t͡ɕən
Brëll	bʁəl
brëlle	bʁələ
brëllen	bʁələn
Brems	bʁæms
bremse	bʁæmzə
bremsen	bʁæmzən
brénge	bʁeŋə
bréngen	bʁeŋən
brenne	bʁænə
brennen	bʁænən
Bretelle	bʁətæl
bretonesch	bʁətoːnəʃ
bretze	bʁæt͡sə
bretzeg	bʁæt͡səɕ
bretzen	bʁæt͡sən
brieche	bʁiə̯ɕə
briechen	bʁiə̯ɕən
Briet	bʁiə̯t
Briquet	bʁikeː
Britt	bʁit
brockelche	bʁokəlɕə
brockelchen	bʁokəlɕən
brode	bʁoːdə
brodéiere	bʁodɜɪ̯əʁə
brodéieren	bʁodɜɪ̯əʁən
broden	bʁoːdən
bromä	bʁomɛː
brong	bʁoŋ
bronkeg	bʁoŋkəɕ
bronz	bʁɑ̃ːs
brooch	bʁoːχ
brooche	bʁoːχə
broochen	bʁoːχən
Broscht	bʁoʃt
Broschür	bʁoʃyʁ
Brot	bʁoːt
Brout	bʁəʊ̯t
broutmaschinn	bʁəʊ̯tmɑʃin
Brudder	bʁudɐ
brüsk	bʁysk
brutal	bʁutaːl
brutsche	bʁut͡ʃə
brutschen	bʁut͡ʃən
buch	buχ
bucht	buχt
Bud	buːt
bude	buːdə
Buden	buːdən
budget	byd͡ʒɛː
budgetsministerinne	byd͡ʒɛːsministəʁinə
buedbidde	buə̯tbidə
Buedbidden	buə̯tbidən
buede	buə̯də
Buedem	buə̯dəm
bueden	buə̯dən
Buedzëmmer	buə̯tt͡səmɐ
buedzëmmerschaf	buə̯tt͡səmɐʃaːf
buerbes	buɐbəs
buere	buə̯ʁə
bueren	buə̯ʁən
buerfouss	buɐfəʊ̯s
Buerg	buɐɕ
Buergermeeschter	buə̯ʑɐmeːʃtɐ
buergermeeschterinne	buɐʑɐmeːʃtəʁinə
buermaschinn	buɐmɑʃin
buermaschinne	buɐmɑʃinə
Buffet	byfeː
Bull	bul
Bulli	buli
bullong	buloŋ
bün	byːn
Büneshow	byːnəʃəuw
Bur	buːʁ
bureau	byʁoː
Büro	byʁoː
bürokratesch	byʁoːkʁaːtəʃ
bürosklamer	byʁoːsklaːmɐ
bus	bus
busbilljee	busbiljeː
Buschauffer	busʃoːfɐ
Buschtaf	buʃtaːf
buschtawéiere	buʃtaːvɜɪ̯əʁə
buschtawéieren	buʃtaːvɜɪ̯əʁən
buslinne	buslinə
bussar	busaːʁ
Buttek	butek
Butteker	butekɐ
butteksfënster	buteksfənstɐ
butzeg	but͡səɕ
cabillaud	kɑbiʒoː
cabine	kɑbin
cabinet	kɑbineː
cabinetspabeier	kɑbineːspɑbɑɪ̯ɐ
cabinne	kɑbinə
cadeau	kɑdoː
café	kɑfeː
caissier	keːsjeː
Caissière	kæsiɛːʁ
calepin	kɑlpɛ̃ː
Camion	kɑmjɑ̃ː
Camionette	kɑmjonæt
Camionschauffer	kɑmjɑ̃ːsʃoːfɐ
campagne	kɑ̃ːmpɑɲ
Campagnë	kɑ̃ːmpɑɲə
Campagnen	kɑ̃ːmpɑɲən
campéiere	kæmpɜɪ̯əʁə
campéieren	kæmpɜɪ̯əʁən
Canapé	kɑnɑpeː
Cantonnier	kɑntonjeː
Capot	kɑpoː
cartouche	kɑʁtuʃ
casserole	kɑsəʁol
cassette	kɑsæt
Cauchemar	koːʃmaːʁ
cd	t͡seːdeː
cendrier	sɑ̃ːdʁijeː
chaiselongue	ʃɛːzlɑ̃ːɡ
chalumeau	ʃɑlymoː
chamberpresidentinne	ʃɑ̃ːmbɐpʁezidæntinə
chamberspresidentinne	ʃɑ̃ːmbɐspʁezidæntinə
Champignon	ʃɑ̃ːpiɲɑ̃ː
Champion	ʃɑ̃ːpjɑ̃ː
chance	ʃɑ̃ːs
change	ʃɑ̃ːʃ
changéiere	ʃɑ̃ːʒɜɪ̯əʁə
changéieren	ʃɑ̃ːʒɜɪ̯əʁən
chantier	ʃɑ̃ːtjeː
chaotinne	ʃaːoːtinə
charmant	ʃɑʁmɑnt
Charme	ʃaːʁm
chaudière	ʃoːdjɛːʁ
Chauffer	ʃoːfɐ
chef	ʃæf
cheffinne	ʃæfinə
chemesch	ʃeːməʃ
cheminee	ʃmineː
chic	ʃik
Chimie	ʃimiː
chinesesch	ʃineːzəʃ
Chips	ʃips
chirurginne	ɕiʁuʁʑinə
choix	ʃwɑ
cholerikerinne	koːleːʁikəʁinə
Cholesterol	koːlæsteʁol
choufleur	ʃuflœːʁ
Chrëschtbeemche	kʁəʃtbeːmɕə
Chrëschtbeemchen	kʁəʃtbeːmɕən
Chrëschtdag	kʁəʃtdaːχ
chrëschtinne	kʁəʃtinə
Chrëschtmaart	kʁəʃtmaːʁt
Claude	kloːdə
clementine	kləmɑ̃ːtin
client	kliɑ̃ː
clientèle	kliɑ̃ːtæl
clinique	klinik
clôture	kloːtyːʁ
Clown	kloːn
CNS	t͡seːænæs
Coiffer	kwɑfɐ
Col	kol
collant	kolɑ̃ː
colle	kol
commissairinne	komisɛːʁinə
Commissioun	komisjəʊ̯n
communiqué	komynikeː
Comptabel	kɑ̃ːtaːbəl
computer	kompjuːtɐ
concert	kɑ̃ːsɛːʁ
Concierge	kɑ̃ːsjɛːʁʃ
conciergë	kɑ̃ːsjɛːʁʒə
conciergen	kɑ̃ːsjɛːʁʒən
concours	kɑ̃ːkuːɐ
congé	kɑ̃ːʒeː
contraire	kɑ̃ːtʁɛːʁ
cool	kuːl
copie	kopiː
cornichon	koʁniʃɑ̃ː
cortège	koʁtɛːʃ
costume	kostym
côte	koːt
coton	kotɑ̃ː
Couchen	kuɕən
courage	kuʁaːʃ
couragéiert	kuʁɑʒɜɪ̯ɐt
courrier	kuʁjeː
cours	kuːɐ
course	kuʁs
coursemaschinn	kuʁsmɑʃin
coursen	kuːəʁən
coursse	kuʁsə
courssen	kuʁsən
Cousin	kuzɛ̃ː
Cousine	kuzin
coussin	kusɛ̃ː
couverte	kuvɛːʁə
couverten	kuvɛːʁən
cravate	kʁɑvɑt
crème	kʁɛːm
crevette	kʁəvæt
cric	kʁik
cricket	kʁikeː
Croissant	kʁwɑsɑ̃ː
d	d̥
da	dɑ
Daach	daːχ
daachdeckerinne	daːχdækəʁinə
Daarm	daːʁm
Dabo	daːboː
daccord	dɑkɔːʁ
dach	dɑχ
dachs	dɑks
dacks	dɑks
dactylo	dɑktiloː
däerfe	dɛːɐfə
däerfen	dɛːɐfən
daf	daːf
dafstomm	daːfʃtom
dag	daːχ
dagdeeglech	daːχdeːɕləɕ
dagesausflich	daːʒəsæːʊ̯sfliɕ
dagesfahrt	daːʒəsfaːʁt
daierlech	dɑɪ̯ɐləɕ
däin	dæːɪ̯n
däischter	dæːɪ̯ʃtɐ
däischtert	dæːɪ̯ʃtɐt
däitlech	dæːɪ̯tləɕ
Däitlechkeet	dæːɪ̯tləɕkeːt
däitsch	dæːɪ̯t͡ʃ
Däitschland	dæːɪ̯t͡ʃlɑnt
Däiwel	dæːɪ̯vəl
däiwelspakt	dæːɪ̯vəlspɑkt
Dall	dɑl
dame	dɑm
Damp	dɑmp
dämpe	dæmpə
dämpen	dæmpən
dänesch	dɛːnəʃ
dann	dɑn
dännebam	dænəbaːm
dännebësch	dænəbəʃ
danz	dɑnt͡s
danze	dɑnt͡sə
danzen	dɑnt͡sən
Dänzer	dænt͡sɐ
Dänzerin	dænt͡səʁin
dänzerinne	dænt͡səʁinə
daper	daːpɐ
Dar	daːʁ
därbaants	dɛːʁbaːnt͡s
Däreldéier	dɛːʁəldɜɪ̯ɐ
dat	daːt
datselwecht	daːtzælvəɕt
datt	dɑt
dattel	dɑtəl
Datum	daːtum
Datz	dɑt͡s
dauche	dæːʊ̯χə
dauchen	dæːʊ̯χən
Dauer	dɑʊ̯ɐ
dauere	dɑʊ̯əʁə
daueren	dɑʊ̯əʁən
Dauf	dɑʊ̯f
Daum	dɑʊ̯m
dausend	dɑʊ̯zənt
de	də
débarras	deːbɑʁaː
deboiséieren	debwɑzɜɪ̯əʁən
debrouilléier	debʁujɜɪ̯ɐ
débrouilléiere	debʁujɜɪ̯əʁə
debrouilléieren	dəbʁujɜɪ̯əʁən
debutant	deːbytɑnt
decalage	deːkɑlaːʃ
dech	dəɕ
decharge	dəʃɑʁʃ
décidéiere	deːsidɜɪ̯əʁə
décidéieren	deːsidɜɪ̯əʁən
déck	dek
decke	dækə
Deckel	dækəl
decken	dækən
déckflësseg	dekfləsəɕ
déckkäppeg	dekkæpəɕ
Declaratioun	deklɑʁaːt͡sjəʊ̯n
déclaréiere	deklɑʁɜɪ̯əʁə
déclaréieren	deklɑʁɜɪ̯əʁən
décor	dekɔːʁ
dee	deː
deefe	deːfə
deefen	deːfən
deeg	deːɕ
deeglaang	deːɕlaːŋ
deeglech	deːɕləɕ
deegwuere	deːɕvuə̯ʁə
deegwueren	deːɕvuə̯ʁən
deel	deːl
deele	deːlə
deelen	deːlən
deelhuele	deːlhuə̯lə
deelhuelen	deːlhuə̯lən
deelweis	deːlvɑɪ̯s
deemno	deːmnoː
deemools	deːmoːls
deen	deːn
deeselwechte	deːzælvəɕtə
deeselwechten	deːzælvəɕtən
déforméiere	defɔʁmɜɪ̯əʁə
déforméieren	defɔʁmɜɪ̯əʁən
defouléiert	dəfulɜɪ̯ɐt
déi	dɜɪ̯
déide	dɜɪ̯də
déiden	dɜɪ̯dən
deier	dɑɪ̯ɐ
déier	dɜɪ̯ɐ
déieregaart	dɜɪ̯əʁəɡaːʁt
déif	dɜɪ̯f
déift	dɜɪ̯ft
déischen	dɜɪ̯sjən
déiselwecht	dɜɪ̯zælvəɕt
Delegatioun	deleɡaːt͡sjəʊ̯n
Delikt	delikt
dëlpessen	dəlpəsən
delphin	dælfiːn
Delta	dæltaː
demande	dəmɑ̃ːt
demaskéier	demɑskɜɪ̯ɐ
Dementi	dəmæntiː
démodéiert	demodɜɪ̯ɐt
demographeschen	demoɡʁaːfəʃən
demographie	demoɡʁaːfiː
demonstrant	demonstʁɑnt
Demonstrante	demonstʁɑntə
Demonstranten	demonstʁɑntən
dëmpe	dəmpə
dëmpen	dəmpən
den	dən
Dénger	deŋɐ
Déngscht	deŋʃt
denke	dæŋkə
denken	dæŋkən
Denkmal	dæŋkmaːl
dënn	dən
Dënschdeg	dənʃdəɕ
dënschdege	dənʃdəʑə
dënschdegen	dənʃdəʑən
dënschdes	dənʃdəs
dépanneuse	depɑnøːs
départ	depaːʁ
depassement	dəpɑsəmɑ̃ː
depassemente	dəpɑsəmɑ̃ːə
depassementen	dəpɑsəmɑ̃ːən
Dëppe	dəpə
Dëppen	dəpən
der	dɐ
derangement	dəʁɑ̃ːʒəmænt
Derangementer	dəʁɑ̃ːʒəmæntɐ
derbäi	dɐbæːɪ̯
dergéint	dɐɡɜɪ̯nt
derhannert	dɐhɑnɐt
dermat	dɐmɑt
dernieft	dɐniə̯ft
deroutéier	deʁutɜɪ̯ɐ
dervun	dɐfun
derwidder	dɐvidɐ
dës	dəs
desaffectéiert	dezɑfæktɜɪ̯ɐt
désagréabel	dezɑɡʁeaːbəl
descente	desɑ̃ːt
Dësch	dəʃ
dëschelduch	dəʃəlduχ
dëschtel	dəʃtəl
dëse	dəzə
dësen	dəzən
dëslescht	dəslæʃt
Dessert	dəsɛːʁ
dëst	dəst
destabiliséieren	destɑbilizɜɪ̯əʁən
desto	dæstoː
detachéiers	detɑʃɜɪ̯ɐs
Detail	detɑj
detektivinne	detæktiːvinə
developpementer	dəvəlopəmæntɐ
Dezember	det͡sæmbɐ
dezent	deːt͡sænt
Dezibel	deːt͡sibæl
Diagnos	diɑɡnoːs
Diagnose	diɑɡnoːzə
diagnostizéieren	diaːɡnostit͡sɜɪ̯əʁən
Dialog	diaːloːχ
Dicher	diɕɐ
dicht	diɕt
dichteg	diɕtəɕ
dichterinne	diɕtəʁinə
Dichtung	diɕtuŋ
Dictée	dikteː
Dictéeën	dikteːən
Dictionnaire	diksjoːnɛːʁ
die	diə̯
diebele	diə̯bələ
diebelen	diə̯bələn
diedege	diə̯dəʑə
diedegen	diə̯dəʑən
dien	diə̯n
dier	diɐ̯
dierfe	diɐ̯fə
dierfen	diɐ̯fən
dierwiechterinne	diɐ̯viə̯ɕtəʁinə
dierze	diɐ̯t͡sə
dierzen	diɐ̯t͡sən
diesel	diːzəl
diffamatoresch	difɑmɑtoːʁəʃ
digestiffen	diʒestifən
digitaalt	diʒitaːlt
digital	diʒitaːl
diichte	diːɕtə
diichten	diːɕtən
diktatorinne	diktaːtoʁinə
dilettant	dilætɑnt
dillendapp	diləndɑp
Dinde	dɛ̃ːd
dindë	dɛ̃ːdə
dinden	dɛ̃ːdən
Diplom	diploːm
diplomatinne	diploːmaːtinə
dir	diɐ̯
dirängele	diːʁæŋələ
dirängelen	diːʁæŋələn
direkt	diʁækt
direkter	diʁæktɐ
direktiounssitzung	diʁækt͡sjəʊ̯nsit͡suŋ
dirigéiere	diʁiʒɜɪ̯əʁə
dirigéieren	diʁiʒɜɪ̯əʁən
Dirigent	diʁiʒænt
dirigentinne	diʁiʒæntinə
discipline	disiplin
disciplinéierten	disiplinɜɪ̯ɐtən
Disco	diskoː
Discoursen	diskuːəʁən
disponibelen	dispoːnibələn
disque	disk
disquë	diskə
Disquen	diskən
Distanz	distɑnt͡s
distributeure	distʁibutœːʁə
Disziplinne	dist͡siplinə
diwan	divɑ̃ː
Diwwi	diviː
do	doː
dobäi	dobæːɪ̯
dobanne	dobɑnə
dobannen	dobɑnən
dobausse	dobæːʊ̯sə
dobaussen	dobæːʊ̯sən
dobehalen	doːbəhaːlən
dobleiwen	doːblɑɪ̯vən
doctrinne	doktʁinə
Documentairen	dokymɑ̃ːtaːiːʁən
dodrun	dodʁun
doe	doːə
doen	doːən
Doft	doft
dohanne	dohɑnə
dohannen	dohɑnən
doheem	doheːm
dohin	dohin
Dokes	dokəs
dokessen	dokəsən
Dokter	doktɐ
Doktesch	doktəʃ
doktrinne	doktʁinə
dokumentéieren	dokumæntɜɪ̯əʁən
dokumentéiers	dokumæntɜɪ̯ɐs
Dolch	dolɕ
doléiner	doːlɜɪ̯nɐ
Dolmetscher	dolmæt͡ʃɐ
dolmetscherinne	dolmæt͡ʃəʁinə
domat	domɑt
domm	dom
Dommheet	domheːt
dompeg	dompəɕ
done	dɑ̃ːə
Donen	dɑ̃ːən
donieft	doniə̯ft
donkel	doŋkəl
donner	donɐ
Donnerwieder	donɐviə̯dɐ
Donneschdeg	donəʃdəɕ
donneschdes	donəʃdəs
dono	doːnoː
Donst	donst
Doppelgänger	dopəlɡæŋɐ
dorobber	doʁobɐ
doropshi	doʁopshi
doropshin	doʁopshin
dosagë	dozaːʒə
dose	dozə
Dosen	dozən
Dosis	doːziːs
dot	doːt
douane	dwɑn
Douanier	dwɑnjeː
doubléieren	dublɜɪ̯əʁən
douce	duːs
doucë	duːsə
doucem	duːsəm
doucen	duːsən
doucestem	duːsəstəm
Douche	duʃ
doud	dəʊ̯t
doudeg	dəʊ̯dəɕ
doudege	dəʊ̯dəʑə
doudegen	dəʊ̯dəʑən
Doudelued	dəʊ̯dəluə̯t
Doudesannonce	dəʊ̯dəzɑnɑ̃ːs
doudmidd	dəʊ̯tmit
doudsécher	dəʊ̯tzəɕɐ
douéiert	duːɜɪ̯ɐt
Dous	dəʊ̯s
doutgekrasch	dəʊ̯tɡəkʁɑʃ
doutgelaacht	dəʊ̯tɡəlaːχt
dovun	dofun
Draach	dʁaːχ
draguéieren	dʁɑɡɜɪ̯əʁən
dräi	dʁæːɪ̯
Dräieck	dʁæːɪ̯ek
dräieckeg	dʁæːɪ̯ekəɕ
dräirad	dʁæːɪ̯ʁaːt
dräizéng	dʁæːɪ̯t͡seŋ
Dram	dʁaːm
dran	dʁɑn
dränke	dʁæŋkə
dränken	dʁæŋkən
Drauf	dʁɑʊ̯f
dréche	dʁəɕə
dréchen	dʁəɕən
dréchent	dʁəɕənt
dréchne	dʁəɕnə
dréchnen	dʁəɕnən
Dreck	dʁæk
drécke	dʁekə
dreckeg	dʁækəɕ
drécken	dʁekən
Dréckerei	dʁekəʁɑɪ̯
drecksak	dʁæksaːk
Dreckskëscht	dʁækskəʃt
Dreckstipp	dʁækstip
dreeën	dʁeːən
dreeme	dʁeːmə
dreemen	dʁeːmən
dréie	dʁɜɪ̯ə
dréien	dʁɜɪ̯ən
dréihälsche	dʁɜɪ̯hælsjə
dréihälschen	dʁɜɪ̯hælsjən
dréngend	dʁeŋənt
drénke	dʁeŋkə
drénken	dʁeŋkən
Drénkgeld	dʁeŋkɡælt
Drénkwaasser	dʁeŋkvaːsɐ
drënner	dʁənɐ
Drëpp	dʁəp
Drëps	dʁəps
Drëpse	dʁəpsə
drëpsen	dʁəpsən
drësseg	dʁəsəɕ
drëtte	dʁətə
drëtten	dʁətən
driibseg	dʁiːpsəɕ
driwwer	dʁivɐ
drobier	dʁoːbiɐ̯
Drock	dʁok
drocksaach	dʁoksaːχ
droe	dʁoːə
droen	dʁoːən
Drog	dʁoːk
Drogen	dʁoːɡən
drogendealerinne	dʁoːɡəndiːləʁinə
drogenhändlerinne	dʁoːɡənhændləʁinə
drogestatistik	dʁoːɡəʃtɑtistik
drogestatistike	dʁoːɡəʃtɑtistikə
drogestatistiken	dʁoːɡəʃtɑtistikən
droguéieren	dʁoːɡɜɪ̯əʁən
droit	dʁwɑ
droleg	dʁoːləɕ
dronkenheet	dʁoŋkənheːt
drop	dʁop
dropgängerinne	dʁopɡæŋəʁinə
dropmaache	dʁopmaːχə
dropmaachen	dʁopmaːχən
dropmouchs	dʁopməʊ̯χs
drot	dʁoːt
druddele	dʁudələ
druddelen	dʁudələn
drugéifen	dʁuɡɜɪ̯fən
drugesaten	dʁuɡəsaːtən
drüs	dʁyːs
du	duː
dübbelen	dybələn
dübel	dyːbəl
Duch	duχ
duché	dyʃeː
ducke	dukə
duckele	dukələ
duckelen	dukələn
ducken	dukən
duebel	duə̯bəl
Duechter	duə̯ɕtɐ
duer	duːɐ
duerch	duːɐɕ
duerchernee	duːɐʑɐneː
duercherneen	duːɐʑɐneːn
duerchfale	duːɐɕfaːlə
duerchfalen	duːɐɕfaːlən
Duerchfall	duːɐɕfɑl
duerchgéifen	duɐɕɡɜɪ̯fən
Duerchschnëttsalter	duːɐɕʃnət͡sɑltɐ
duerchsichteg	duːɐɕziɕtəɕ
duerchsträiche	duːɐɕʃtʁæːɪ̯ɕə
duerchsträichen	duːɐɕʃtʁæːɪ̯ɕən
duerchwulle	duːɐɕvulə
duerchwullen	duːɐɕvulən
duerf	duɐf
duerfe	duːɐfə
duerfen	duɐfən
duerfir	duɐfiɐ̯
duergoe	duːɐɡoːə
duergoen	duɐɡoːən
duerkomme	duːɐkomə
duerkommen	duɐkomən
duerno	duɐnoː
Dünger	dyŋɐ
dunn	dun
dure	dyːʁ
Dusch	duʃ
duschcabinne	duʃkɑbinə
dusche	duʃə
duschen	duʃən
duschkabinne	duʃkɑbinə
Dusel	duzəl
Duuscht	duːʃt
duuss	duːs
duze	duːt͡sə
duzen	duːt͡sən
dynastie	dinɑstiː
e	ə
ebe	eːbə
eben	eːbən
Ecart	ekaːʁ
ecarte	ekaːʁə
ecarten	ekaːʁən
ech	əɕ
Echange	əʃɑ̃ːʃ
Echangë	əʃɑ̃ːʒə
Echangen	əʃɑ̃ːʒən
échantillon	əʃɑ̃ːtijɑ̃ː
Echantillon	əʃɑ̃ːtjɑ̃ː
Echantillone	əʃɑ̃ːtjɑ̃ːə
Echantillonen	əʃɑ̃ːtjɑ̃ːən
echeance	əʃeɑ̃ːs
echeancë	əʃeɑ̃ːsə
echeancen	əʃeɑ̃ːsən
Echec	əʃæk
echecke	əʃækə
Echecken	əʃækən
echt	æɕt
eck	æk
eckeg	ækəɕ
Ecran	eːkʁɑ̃ː
Ecrane	eːkʁɑ̃ːə
Ecranen	eːkʁɑ̃ːən
edelstee	eːdəlʃteː
edelsteen	eːdəlʃteːn
educatiounsprojeten	eːdukaːt͡sjəʊ̯nspʁoʒeːən
ee	eː
Eech	eːɕ
eechel	eːɕəl
Eed	eːt
Eedem	eːdəm
eeërschuel	eːɐʃuə̯l
eeërstack	eːɐʃtɑk
eefälleg	eːfæləɕ
Eefalt	eːfɑlt
eege	eːʑə
eegen	eːʑən
eegentemer	eːʑəntəmɐ
eegentlech	eːʑəntləɕ
eegentom	eːʑəntom
Eegiel	eːɡiə̯l
eekele	eːkələ
eekeleg	eːkələɕ
eekelen	eːkələn
eekle	eːklə
eekleg	eːkləɕ
eeklen	eːklən
eelef	eːləf
eeler	eːlɐ
eelst	eːlst
eelste	eːlstə
eelsten	eːlstən
eelze	eːlt͡sə
eelzen	eːlt͡sən
Eemer	eːmɐ
eemol	eːmoːl
een	eːn
eenege	eːnəʑə
eenegen	eːnəʑən
eent	eːnt
eenzeg	eːnt͡səɕ
eenzege	eːnt͡səʑə
eenzegen	eːnt͡səʑən
eenzegt	eːnt͡səɕt
eenzel	eːnt͡səl
eenzelheete	eːnt͡səlheːtə
Eenzelheeten	eːnt͡səlheːtən
eenzock	eːnt͡sok
eescht	eːʃt
eeschtlech	eːʃtləɕ
eess	eːs
eeter	eːtɐ
Eewäiss	eːvæːɪ̯s
efeu	eːfoɪ
effete	æfeːə
Effeten	æfeːən
efficacen	æfikɑsən
efficacer	æfikɑsɐ
efficacest	æfikɑsəst
efficacet	æfikɑst
effiziente	æfit͡sjænt
effizienter	æfit͡sjæntɐ
effort	æfɔːʁ
Efforte	æfɔːʁə
Efforten	æfɔːʁən
egal	eɡaːl
égout	eɡuː
Eidechs	ɑɪ̯dæks
eidel	ɑɪ̯dəl
éier	ɜɪ̯ɐ
éierbar	ɜɪ̯ɐbaːʁ
éierewou	ɜɪ̯əʁəwəʊ̯
Éiergäiz	ɜɪ̯ɐɡæːɪ̯t͡s
éiergäizeg	ɜɪ̯ɐɡæːɪ̯t͡səɕ
éierlech	ɜɪ̯ɐləɕ
eigentlech	ɑɪ̯ʑəntləɕ
Eil	ɑɪ̯l
éil	ɜɪ̯l
einfach	ɑɪ̯nfɑχ
Einsamkeet	ɑɪ̯nzaːmkeːt
eintlech	ɑɪ̯ntləɕ
eis	ɑɪ̯s
éischt	ɜɪ̯ʃt
éischte	ɜɪ̯ʃtə
éischten	ɜɪ̯ʃtən
éischter	ɜɪ̯ʃtɐ
eise	ɑɪ̯zə
Eisebunn	ɑɪ̯zebun
Eisebunner	ɑɪ̯zebunɐ
eisekuch	ɑɪ̯zekuχ
eisen	ɑɪ̯zən
eisepäertche	ɑɪ̯zəpɛːɐt͡ɕə
eisepäertchen	ɑɪ̯zəpɛːɐt͡ɕən
eiser	ɑɪ̯zɐ
Éislek	ɜɪ̯slek
eist	ɑɪ̯st
éiweg	ɜɪ̯vəɕ
éiwegkeet	ɜɪ̯vəɕkeːt
Ekel	eːkəl
ekologistinne	eːkoːloɡistinə
ekonomistinne	eːkoːnoːmistinə
elaboréieren	elɑboʁɜɪ̯əʁən
elauter	əlæːʊ̯tɐ
Elch	ælɕ
elefeant	ələfɑnt
elei	əlɑɪ̯
Elektriker	elæktʁikɐ
elementar	ələmæntaːʁ
elementarem	ələmæntaːʁəm
Elementer	ələmæntɐ
eleng	əlæŋ
elitär	elitɛːʁ
elitären	elitɛːʁən
elle	ælə
ellen	ælən
elo	əloː
Eltere	æltəʁə
elteren	æltəʁən
ëm	əm
emäermele	əmɛːɐmələ
emäermelen	əmɛːɐmələn
email	emɑj
émail	emɑj
emailléier	emɑjɜɪ̯ɐ
ëmännere	əmænəʁə
ëmänneren	əmænəʁən
Emballage	ɑ̃ːmbɑlaːʃ
emballagë	ɑ̃ːmbɑlɑʒə
emballagen	ɑ̃ːmbɑlaːʒən
embargo	æmbɑʁɡoː
ëmbloost	əmbloːst
embolie	ɑ̃ːmboliː
ëmbrénge	əmbʁeŋə
ëmbréngen	əmbʁeŋən
Embryo	æmbʁioː
Embryoe	æmbʁioːə
ëmdréie	əmdʁɜɪ̯ə
ëmdréien	əmdʁɜɪ̯ən
Ëmfang	əmfɑŋ
emfank	əmfɑŋk
emfänke	əmfæŋkə
emfänken	əmfæŋkən
emfindlech	əmfindləɕ
ëmfro	əmfʁoː
Emgéigend	əmɡɜɪ̯ʑənt
ëmgeréits	əmɡəʁɜɪ̯t͡s
ëmkomme	əmkomə
ëmkommen	əmkomən
ëmleede	əmleːdə
ëmleeden	əmleːdən
ëmmer	əmɐ
emol	əmoːl
emotionaler	emot͡sjoːnaːlɐ
Emotioun	emotjəʊ̯n
ëmpeg	əmpəɕ
empfaangen	æmp͡faːŋən
Empfang	æmp͡fɑŋ
empfindlech	æmp͡findləɕ
Employé	ɑ̃ːplwɑjeː
emsoss	əmzos
ëmstand	əmʃtɑnt
ëmstousse	əmʃtəʊ̯sə
ëmstoussen	əmʃtəʊ̯sən
Ëmwee	əmweː
en	ən
Enceinte	ɑ̃ːsɛ̃ːt
endege	ændəʑə
endegen	ændəʑən
endlech	ændləɕ
energie	enɛʁʒiː
eng	æŋ
engagéiere	ɑ̃ːɡaːʒɜɪ̯əʁə
engagéieren	ɑ̃ːɡaːʒɜɪ̯əʁən
Engel	æŋəl
engem	æŋəm
England	æŋlɑnt
Englänner	æŋlænɐ
Englännerin	æŋlænəʁin
englesch	æŋləʃ
enk	æŋk
Enkel	æŋkəl
Enkelkand	æŋkəlkɑnt
Enn	æn
ënn	ən
ënne	ənə
ënnen	ənən
ënnenan	ənənɑn
ënner	ənɐ
ënnerbrieche	ənɐbʁiə̯ɕə
ënnerbriechen	ənɐbʁiə̯ɕən
ënnerdaach	ənɐdaːχ
ënnergehëlz	ənɐɡəhəlt͡s
ënnergoe	ənɐɡoːə
ënnergoen	ənɐɡoːən
ënnerhale	ənɐhaːlə
ënnerhalen	ənɐhaːlən
ënnerhuele	ənɐhuə̯lə
ënnerhuelen	ənɐhuə̯lən
ënnerläif	ənɐlæːɪ̯f
ënnerriichte	ənɐʁiːɕtə
ënnerriichten	ənɐʁiːɕtən
ënnerscheed	ənɐʃeːt
ënnerscheede	ənɐʃeːdə
ënnerscheeden	ənɐʃeːdən
Ënnerschrëft	ənɐʃʁəft
ënnerschreiwe	ənɐʃʁɑɪ̯və
ënnerschreiwen	ənɐʃʁɑɪ̯vən
ënnersiche	ənɐziɕə
ënnersichen	ənɐziɕən
ënnerstëtzung	ənɐʃtət͡suŋ
ënnersträiche	ənɐʃtʁæːɪ̯ɕə
ënnersträichen	ənɐʃtʁæːɪ̯ɕən
ënnert	ənɐt
ënnertenaner	ənɐtənaːnɐ
Ënnerwäsch	ənɐvæʃ
ënnerwee	ənɐveː
ënnerwierfeg	ənɐviə̯fəɕ
enniichter	əniːɕtɐ
enorm	enɔʁm
entdecke	əntdækə
entdecken	əntdækən
entdeeën	əntdeːən
entfale	əntfaːlə
entfalen	əntfaːlən
enthale	ənthaːlə
enthalen	ənthaːlən
entnäipe	əntnæːɪ̯pə
entnäipen	əntnæːɪ̯pən
entpuppe	əntpupə
entpuppen	əntpupən
entrée	ɑ̃ːtʁeː
Entrepreneur	ɑ̃ːtʁəpʁənɐ
entrevue	ɑ̃ːtʁəvyː
entscheede	ənt͡ʃeːdə
entscheeden	ənt͡ʃeːdən
entschëllege	ənt͡ʃələʑə
entschëllegen	ənt͡ʃələʑən
entschiedege	ənt͡ʃiə̯dəʑə
entschiedegen	ənt͡ʃiə̯dəʑən
entschlofe	ənt͡ʃloːfə
entschlofen	ənt͡ʃloːfən
entwéckele	əntvekələ
entwéckelen	əntvekələn
entwerfe	əntvɛʁfə
entwerfen	əntvɛʁfən
entworf	əntvɔʁf
entwutsche	əntvut͡ʃə
entwutschen	əntvut͡ʃən
entziffere	əntt͡sifəʁə
entzifferen	əntt͡sifəʁən
Enveloppe	ɑ̃ːvəlop
épicerie	episəʁiː
épicier	episjeː
Epidemien	epideːmiːən
epilatioun	epilaːt͡sjəʊ̯n
epilatioune	epilaːt͡sjəʊ̯nə
epilatiounen	epilaːt͡sjəʊ̯nən
epiléier	epilɜɪ̯ɐ
Epilepsie	epileːpsiː
epileptesch	epilæptəʃ
eponge	epɑ̃ːʃ
epongen	epɑ̃ːʒən
eppes	æpəs
équipe	ekip
equivalenz	eːkiːvaːlænt͡s
eragoe	əʁɑɡoːə
eragoen	əʁɑɡoːən
eraklappbar	əʁɑklɑpbaːʁ
erakomme	əʁɑkomə
erakommen	əʁɑkomən
eran	əʁɑn
eraus	əʁæːʊ̯s
erausfanne	əʁæːʊ̯sfɑnə
erausfannen	əʁæːʊ̯sfɑnən
erausgoe	əʁæːʊ̯sɡoːə
erausgoen	əʁæːʊ̯sɡoːən
eraushuele	əʁæːʊ̯shuə̯lə
eraushuelen	əʁæːʊ̯shuə̯lən
erausklamme	əʁæːʊ̯sklɑmə
erausklammen	əʁæːʊ̯sklɑmən
erauskomme	əʁæːʊ̯skomə
erauskommen	əʁæːʊ̯skomən
erausrappe	əʁæːʊ̯sʁɑpə
erausrappen	əʁæːʊ̯sʁɑpən
erausschëdde	əʁæːʊ̯sʃədə
erausschëdden	əʁæːʊ̯sʃədən
eraussiche	əʁæːʊ̯sziɕə
eraussichen	əʁæːʊ̯sziɕən
erbäilafe	ɐbæːɪ̯laːfə
erbäilafen	ɐbæːɪ̯laːfən
erbléckse	ɐbleksə
erblécksen	ɐbleksən
erblose	ɐbloːzə
erblosen	ɐbloːzən
erbrieche	ɐbʁiə̯ɕə
erbriechen	ɐbʁiə̯ɕən
erdiischtere	ɐdiːʃtəʁə
erdiischteren	ɐdiːʃtəʁən
erdrag	ɐdʁaːχ
Erdrénke	ɐdʁeŋkə
erdrénken	ɐdʁeŋkən
erdroe	ɐdʁoːə
erdroen	ɐdʁoːən
eréischt	əʁɜɪ̯ʃt
erëm	əʁəm
erëmbrénge	əʁəmbʁeŋə
erëmbréngen	əʁəmbʁeŋən
erëmfanne	əʁəmfɑnə
erëmfannen	əʁəmfɑnən
erëmgesi	əʁəmɡəzi
erëmgesinn	əʁəmɡəzin
erëmgi	əʁəmɡi
erëmginn	əʁəmɡin
erëmkenne	əʁəmkænə
erëmkennen	əʁəmkænən
erëmkomme	əʁəmkomə
erëmkommen	əʁəmkomən
erëmkréie	əʁəmkʁɜɪ̯ə
erëmkréien	əʁəmkʁɜɪ̯ən
erënnere	ɐənəʁə
erënneren	ɐənəʁən
Erënnerung	ɐənəʁuŋ
erfanne	ɐfɑnə
erfannen	ɐfɑnən
erféiere	ɐfɜɪ̯əʁə
erféieren	ɐfɜɪ̯əʁən
Erfolleg	ɐfoləɕ
erfréiere	ɐfʁɜɪ̯əʁə
erfréieren	ɐfʁɜɪ̯əʁən
erhéiung	ɐhɜɪ̯uŋ
erhéngere	ɐheŋəʁə
erhéngeren	ɐheŋəʁən
Erhuelung	ɐhuə̯luŋ
eriwwer	əʁivɐ
eriwwergoe	əʁivɐɡoːə
eriwwergoen	əʁivɐɡoːən
erkale	ɐkaːlə
erkalen	ɐkaːlən
Erkältung	ɐkæltuŋ
erkenne	ɐkænə
erkennen	ɐkænən
erkläre	ɐklɛːʁə
erklären	ɐklɛːʁən
erlaabnes	ɐlaːbnəs
erlaabs	ɐlaːps
erlabe	ɐlaːbə
erlaben	ɐlaːbən
erleedege	ɐleːdəʑə
erleedegen	ɐleːdəʑən
erléise	ɐlɜɪ̯zə
erléisen	ɐlɜɪ̯zən
erliewe	ɐliə̯və
erliewen	ɐliə̯vən
erliichtere	ɐliːɕtəʁə
erliichteren	ɐliːɕtəʁən
ermiddend	ɐmidənt
erneiere	ɐnɑɪ̯əʁə
erneieren	ɐnɑɪ̯əʁən
erniere	ɐniə̯ʁə
ernieren	ɐniə̯ʁən
ernimme	ɐnimə
ernimmen	ɐnimən
erof	əʁoːf
erofdroe	əʁoːfdʁoːə
erofdroen	əʁoːfdʁoːən
eroffale	əʁoːffaːlə
eroffalen	əʁoːffaːlən
erofgoe	əʁoːfɡoːə
erofgoen	əʁoːfɡoːən
erofloosse	əʁoːfloːsə
erofloossen	əʁoːfloːsən
erofmaache	əʁoːfmaːχə
erofmaachen	əʁoːfmaːχən
erofrappe	əʁoːfʁɑpə
erofrappen	əʁoːfʁɑpən
erop	əʁop
eropdroe	əʁopdʁoːə
eropdroen	əʁopdʁoːən
eropgoe	əʁopɡoːə
eropgoen	əʁopɡoːən
eropklamme	əʁopklɑmə
eropklammen	əʁopklɑmən
eropkomme	əʁopkomə
eropkommen	əʁopkomən
erreeche	ɐʁeːɕə
erreechen	ɐʁeːɕən
Erreger	ɐʁeːʑɐ
ersatzstéck	ɐzɑt͡sʃtek
ersaufe	ɐzæːʊ̯fə
ersaufen	ɐzæːʊ̯fən
erschénge	ɐʃeŋə
erschéngen	ɐʃeŋən
ersetze	ɐsæt͡sə
ersetzen	ɐsæt͡sən
erstécke	ɐʃtekə
erstécken	ɐʃtekən
eruewere	ɐuə̯veʁə
erueweren	ɐuə̯veʁən
eruewerung	ɐuə̯vəʁuŋ
ervirdoe	ɐfiɐ̯doːə
ervirdoen	ɐfiɐ̯doːən
ervirhiewe	ɐfiɐ̯hiə̯və
ervirhiewen	ɐfiɐ̯hiə̯vən
erwaarde	ɐvaːʁdə
erwaarden	ɐvaːʁdən
Erwaardung	ɐvaːʁduŋ
erwäche	ɐvæɕə
erwächen	ɐvæɕən
erwësche	ɐvəʃə
erwëschen	ɐvəʃən
erwierge	ɐviə̯ʑə
erwiergen	ɐviə̯ʑən
erwuess	ɐvuə̯s
erwuessene	ɐvuə̯sənə
erwuessenen	ɐvuə̯sənən
erzéie	ɐt͡sɜɪ̯ə
erzéien	ɐt͡sɜɪ̯ən
Erzéiung	ɐt͡sɜɪ̯uŋ
erziele	ɐt͡siə̯lə
erzielen	ɐt͡siə̯lən
Erzielung	ɐt͡siə̯luŋ
esch	æʃ
esou	əzəʊ̯
esoubal	əzəʊ̯baːl
esouguer	əzəʊ̯ɡuɐ
Esseg	æsəɕ
et	ət
Etgen	ətʑən
Etikett	etikæt
etlech	ætləɕ
etlechmol	ætləɕmoːl
Etüd	eːtyːt
europa	oɪʁoːpaː
europäesch	oɪʁoːpɛːəʃ
ewechbrénge	əvəɕbʁeŋə
ewechbréngen	əvəɕbʁeŋən
ewechgi	əvəɕɡi
ewechginn	əvəɕɡin
ewechhuele	əvəɕhuə̯lə
ewechhuelen	əvəɕhuə̯lən
ewell	əvæl
Exame	æɡzaːmə
examen	æɡzaːmən
exercice	æɡzɐsis
Experienz	ækspɛːʁjænt͡s
Expertise	ækspɛːʁtiːs
Export	ækspɔʁt
Expositioun	ækspozit͡sjəʊ̯n
express	ækspʁæs
extere	ækstæʁə
exteren	ækstæʁən
exzellent	æksælænt
Faarf	faːʁf
faarfdëppe	faːʁfdəpə
faarfdëppen	faːʁfdəpən
faarweg	faːʁvəɕ
Faaschte	faːʃtə
faaschten	faːʃtən
Faass	faːs
Fabréck	fɑbʁek
fabrizéiere	fɑbʁit͡sɜɪ̯əʁə
fabrizéieren	fɑbʁit͡sɜɪ̯əʁən
facteur	fɑktœːʁ
fad	faːt
fäeg	fɛːəɕ
fäert	fɛːɐt
fäerte	fɛːɐtə
fäerten	fɛːɐtən
fal	faːl
fale	faːlə
falen	faːlən
fall	fɑl
Fallschierm	fɑlʃiɐ̯m
FALSCH	fɑlʃ
fälsche	fælʃə
fälschen	fælʃən
faméis	fɑmɜɪ̯s
familiär	fɑmiljɛːʁ
Famill	fɑmil
Familljennumm	fɑmiljənum
Fändel	fændəl
Fanger	fɑŋɐ
fänke	fæŋkə
fänken	fæŋkən
fanne	fɑnə
fannen	fɑnən
fantastesch	fɑntɑstəʃ
far	faːʁ
fasan	fɑzaːn
Fassad	fɑsaːt
Fatz	fɑt͡s
fatzeg	fɑt͡səɕ
Faubourg	foːbuːɐ
faul	fɑʊ̯l
faule	fɑʊ̯lə
faulen	fɑʊ̯lən
faulenze	fæːʊ̯lænt͡sə
faulenzen	fæːʊ̯lænt͡sən
Fauscht	fæːʊ̯ʃt
favoriséiere	fɑvoʁisɜɪ̯əʁə
favoriséieren	fɑvoʁisɜɪ̯əʁən
Fax	fɑks
Februar	feːbʁuaːʁ
fechte	fæɕtə
fechten	fæɕtən
feele	feːlə
feelen	feːlən
Feeler	feːlɐ
feescht	feːʃt
feier	fɑɪ̯ɐ
Feierblumm	fɑɪ̯ɐblum
feiere	fɑɪ̯əʁə
féiere	fɜɪ̯əʁə
feieren	fɑɪ̯əʁən
féieren	fɜɪ̯əʁən
feierkuerf	fɑɪ̯ɐkuɐf
feierlech	fɑɪ̯ɐləɕ
feierrout	fɑɪ̯ɐʁəʊ̯t
feig	fɑɪ̯ɕ
Feigheet	fɑɪ̯ɕheːt
feigling	fɑɪ̯ɕliŋ
Feil	fɑɪ̯l
feile	fɑɪ̯lə
feilen	fɑɪ̯lən
Feind	fɑɪ̯nt
Féiwer	fɜɪ̯vɐ
féiwereg	fɜɪ̯vəʁəɕ
Feld	fælt
feldhong	fælthoŋ
Feldwee	fæltweː
felg	fælɕ
félicitatioun	felisitaːt͡sjəʊ̯n
félicitéiere	felisitɜɪ̯əʁə
félicitéieren	felisitɜɪ̯əʁən
fëlle	fələ
fëllen	fələn
fëmme	fəmə
fëmmen	fəmən
Fëmmert	fəmɐt
fénkele	feŋkələ
fénkelen	feŋkələn
fënnef	fənəf
fënnefte	fənəftə
fënneften	fənəftən
Fënster	fənstɐ
Fernand	fɛʁnɑ̃ː
Fernseh	fɛʁnzeː
Fësch	fəʃ
fësche	fəʃə
fëschen	fəʃən
Fëscher	fəʃɐ
fëscherboot	fəʃɐboːt
fëschfänke	fəʃfæŋkə
fëschfänken	fəʃfæŋkən
Fëschmaart	fəʃmaːʁt
fëschrutt	fəʃʁut
fest	fæst
festmaache	fæstmaːχə
festmaachen	fæstmaːχən
feststelle	fæst͡ʃtælə
feststellen	fæst͡ʃtælən
Festung	fæstuŋ
fett	fæt
fetteg	fætəɕ
ficelle	fisæl
fiddere	fidəʁə
fidderen	fidəʁən
Fieder	fiə̯dɐ
fiederball	fiə̯dɐbɑl
Fiels	fiə̯ls
fierchterlech	fiə̯ɕtɐləɕ
fierkel	fiɐ̯kəl
fierschter	fiə̯ʃtɐ
fierwe	fiɐ̯və
fierwen	fiɐ̯vən
fiffeg	fifəɕ
fiffi	fifiː
Fig	fiːk
Figur	fiɡuːʁ
fiicht	fiːɕt
Fiissche	fiːsjə
Fiisschen	fiːsjən
filet	fileː
Filial	filjaːl
fille	filə
fillen	filən
film	film
fils	fis
Filter	filtɐ
filtere	filtəʁə
filteren	filtəʁən
filz	filt͡s
finale	finɑl
Finall	finɑl
Firma	fiʁmaː
firmung	fiʁmuŋ
firwat	fiɐ̯vaːt
Fischi	fiʃiː
fisele	fizələ
fiselen	fizələn
fiselree	fizəlʁeː
fiselreen	fizəlʁeːn
Fixfeier	fiksfɑɪ̯ɐ
Fixspoun	fiksʃpəʊ̯n
fize	fiːt͡sə
fizen	fiːt͡sən
flaach	flaːχ
flackere	flɑkəʁə
flackeren	flɑkəʁən
Fläiss	flæːɪ̯s
fläisse	flæːɪ̯sə
fläisseg	flæːɪ̯səɕ
fläissen	flæːɪ̯sən
Flam	flaːm
Flame	flaːmə
flamen	flaːmən
flämesch	flɛːməʃ
flantermaus	flɑntɐmaːus
flantesseg	flɑntəsəɕ
Fläsch	flæʃ
fläschelche	flæʃəlɕə
fläschelchen	flæʃəlɕən
flätsch	flæt͡ʃ
flauscheg	flæːʊ̯ʃəɕ
Fleck	flæk
flécke	flekə
flécken	flekən
fleege	fleːʑə
fleegen	fleːʑən
Fleesch	fleːʃ
fleeschwollef	fleːʃwoləf
fleete	fleːtə
fleeten	fleːtən
fléie	flɜɪ̯ə
fléien	flɜɪ̯ən
Flemm	flæm
flemmseg	flæmsəɕ
flénk	fleŋk
Flënt	flənt
flësseg	fləsəɕ
Flicht	fliɕt
Fliger	fliːʑɐ
Flillek	flilek
flom	floːm
Floss	flos
flott	flot
flou	fləʊ̯
Floumaart	fləʊ̯maːʁt
flu	fluː
Fluch	fluχ
fluche	fluχə
fluchen	fluχən
Fluchhafen	fluːχhaːfən
Flughafe	fluːχhaːfə
Flughafen	fluːχhaːfən
flüstere	flystəʁə
flüsteren	flystəʁən
Flütt	flyt
fochs	foks
focke	fokə
focken	fokən
fofzeg	foft͡səɕ
fofzéng	foft͡seŋ
Föhn	føːn
Foire	fwaːʁ
folleche	foləɕə
follechen	foləɕən
Folter	foltɐ
fonctionnéiere	foŋksjoːnɜɪ̯əʁə
fonctionnéieren	foŋksjoːnɜɪ̯əʁən
Fonke	foŋkə
fonkelnei	foŋkəlnɑɪ̯
Fonken	foŋkən
foosche	foːʃə
fooschen	foːʃən
Football	futbɑl
footing	fuːtiŋ
forell	foʁæl
Form	fɔʁm
forme	fɔʁmə
formen	fɔʁmən
Forschette	fɔʁʃæt
fort	fɔʁt
fortfléie	fɔʁtflɜɪ̯ə
fortfléien	fɔʁtflɜɪ̯ən
fortgoe	fɔʁtɡoːə
fortgoen	fɔʁtɡoːən
fortlafe	fɔʁtlaːfə
fortlafen	fɔʁtlaːfən
fortschécke	fɔʁt͡ʃekə
fortschécken	fɔʁt͡ʃekən
Fotell	foːtæl
foto	fotoː
Fotoapparat	fotoːɑpɑʁaːt
Fotograf	fotoːɡʁaːf
Fouer	fəʊ̯ɐ
Foulard	fulaːʁ
Fouss	fəʊ̯s
Foussball	fəʊ̯sbɑl
Foussgänger	fəʊ̯sɡæŋɐ
Foussgängerzon	fəʊ̯sɡæŋɐt͡soːn
foussteppech	fəʊ̯stæpəɕ
fra	fʁaː
Fracht	fʁɑχt
frachtschëff	fʁɑχt͡ʃəf
fräi	fʁæːɪ̯
fräie	fʁæːɪ̯ə
fräien	fʁæːɪ̯ən
Fräiheet	fʁæːɪ̯heːt
fräiwëlleg	fʁæːɪ̯vələɕ
Fräizäit	fʁæːɪ̯t͡sæːɪ̯t
François	fʁɑ̃ːswɑ
Françoise	fʁɑ̃ːswɑs
Frang	fʁɑŋ
Frankräich	fʁɑŋkʁæːɪ̯ɕ
franséisch	fʁɑnzɜɪ̯ʃ
Fransous	fʁɑnzəʊ̯s
Fräsch	fʁæʃ
fräschmann	fʁæʃmɑn
Frascht	fʁɑʃt
fraschtknupp	fʁɑʃtknup
frech	fʁæɕ
Freed	fʁeːt
Freedefeier	fʁeːdəfɑɪ̯ɐ
fréi	fʁɜɪ̯
Freideg	fʁɑɪ̯dəɕ
freides	fʁɑɪ̯dəs
freie	fʁɑɪ̯ə
freien	fʁɑɪ̯ən
freier	fʁɑɪ̯ɐ
fréier	fʁɜɪ̯ɐ
fréiere	fʁɜɪ̯əʁə
fréieren	fʁɜɪ̯əʁən
Freiesch	fʁɑɪ̯əʃ
Fréijor	fʁɜɪ̯joːʁ
frell	fʁæl
Frënd	fʁənt
Frëndin	fʁəndin
frëndlech	fʁəndləɕ
Frëndschaft	fʁənt͡ʃɑft
frëndschaftlech	fʁənt͡ʃɑftləɕ
frësch	fʁəʃ
frettche	fʁæt͡ɕə
frettchen	fʁæt͡ɕən
Fridde	fʁidə
Fridden	fʁidən
friddlech	fʁidləɕ
friem	fʁiə̯m
frieme	fʁiə̯mə
friemen	fʁiə̯mən
friesse	fʁiə̯sə
friessen	fʁiə̯sən
Frigidaire	fʁiʒidɛːʁ
Frigo	fʁiɡoː
fritt	fʁit
Frittebud	fʁitəbuːt
fro	fʁoː
froe	fʁoːə
froen	fʁoːən
fromm	fʁom
fronze	fʁont͡sə
fronzen	fʁont͡sən
frou	fʁəʊ̯
fruchtbar	fʁuχtbaːʁ
Fruucht	fʁuːχt
fuddele	fudələ
fuddelen	fudələn
Fudder	fudɐ
fuebele	fuə̯bələ
fuebelen	fuə̯bələn
Fuedem	fuə̯dəm
Fuendel	fuə̯ndəl
fuerchtbar	fuɐɕtbaːʁ
fuerdere	fuə̯dəʁə
fuerderen	fuə̯dəʁən
fuere	fuə̯ʁə
fueren	fuə̯ʁən
Fuerf	fuɐf
fuersche	fuɐʃə
fuerschen	fuɐʃən
fuerweg	fuɐvəɕ
Fuesbal	fuə̯sbaːl
Fuesent	fuə̯sənt
fueskostüm	fuə̯skostym
Führerschäin	fyːʁɐʃæːɪ̯n
füllfieder	fylfiə̯dɐ
fummele	fumələ
fummelen	fumələn
fusche	fuʃə
fuschen	fuʃən
futti	futi
futur	fytyːʁ
füügt	fyːɕt
Fuuss	fuːs
fuusseg	fuːsəɕ
gaangs	ɡaːŋs
Gaapse	ɡaːpsə
gaapsen	ɡaːpsən
gaardeboun	ɡaːʁdəbəʊ̯n
gaardenhaische	ɡaːʁdənhɑɪ̯sjə
Gaardenhaischen	ɡaːʁdənhɑɪ̯sjən
Gaart	ɡaːʁt
Gaascht	ɡaːʃt
gaaschtfrëndlech	ɡaːʃtfʁəndləɕ
Gaass	ɡaːs
Gäertner	ɡɛːɐtnɐ
Gaffe	ɡɑf
gäissel	ɡæːɪ̯səl
gäizeg	ɡæːɪ̯t͡səɕ
gäizhals	ɡæːɪ̯t͡shɑls
gakeg	ɡaːkəɕ
gal	ɡaːl
Gangster	ɡæŋstɐ
Gank	ɡɑŋk
Gäns	ɡæns
ganz	ɡɑnt͡s
gär	ɡɛːʁ
garage	ɡɑʁaːʃ
Garagë	ɡɑʁaːʒə
Garagen	ɡɑʁaːʒən
garantéiere	ɡɑʁɑ̃ːntɜɪ̯əʁə
garantéieren	ɡɑʁɑ̃ːntɜɪ̯əʁən
garçon	ɡɑʁsɑ̃ː
gare	ɡaːʁ
Gas	ɡaːs
Gaston	ɡɑstɑ̃ː
Gebai	ɡəbɑɪ̯
Gebaier	ɡəbɑɪ̯ɐ
gebastels	ɡəbɑstəls
gebéck	ɡəbek
Gebeess	ɡəbeːs
gebeessglas	ɡəbeːsɡlaːs
Gebëss	ɡəbəs
gebiet	ɡəbiə̯t
gebills	ɡəbils
gebilt	ɡəbilt
gebimmels	ɡəbiməls
Gebitt	ɡəbit
gebläers	ɡəblɛːɐs
Gebraddels	ɡəbʁɑdəls
Gebräicher	ɡəbʁæːɪ̯ɕɐ
gebräicherlech	ɡəbʁæːɪ̯ɕɐləɕ
gebrauch	ɡəbʁæːʊ̯χ
gebrode	ɡəbʁoːdə
gebroden	ɡəbʁoːdən
gebuert	ɡəbuɐt
Gebuertsdag	ɡəbuɐt͡sdaːχ
gebuertsdagskaart	ɡəbuɐt͡sdaːχskaːʁt
Gebuertsdagskuch	ɡəbuɐt͡sdaːχskuχ
Geck	ɡæk
geckeg	ɡækəɕ
geckegkeet	ɡækəɕkeːt
Geckenhaus	ɡækənhæːʊ̯s
geckse	ɡæksə
gecksen	ɡæksən
Gedeessems	ɡədeːsəms
Gedéiesch	ɡədɜɪ̯əʃ
gedëlleg	ɡədələɕ
gedicht	ɡədiɕt
Gedold	ɡədolt
Gedrécks	ɡədʁeks
Gedrénks	ɡədʁeŋks
gëeegent	ɡəeːʑənt
Geescht	ɡeːʃt
Geeschterbunn	ɡeːʃtɐbun
geess	ɡeːs
Gefaangene	ɡəfaːŋənə
Gefaangenen	ɡəfaːŋənən
gefale	ɡəfaːlə
gefalen	ɡəfaːlən
gefälleg	ɡəfæləɕ
Gefecht	ɡəfæɕt
geféierlech	ɡəfɜɪ̯ɐləɕ
Gefill	ɡəfil
Gefor	ɡəfoːʁ
Gëft	ɡəft
gëfteg	ɡəftəɕ
gehacktes	ɡəhɑktəs
gehässeg	ɡəhæsəɕ
geheie	ɡəhɑɪ̯ə
geheien	ɡəhɑɪ̯ən
Gehéier	ɡəhɜɪ̯ɐ
gehéiere	ɡəhɜɪ̯əʁə
gehéieren	ɡəhɜɪ̯əʁən
geheim	ɡəhɑɪ̯m
geheimnes	ɡəhɑɪ̯mnəs
Gehir	ɡəhiɐ̯
Gei	ɡɑɪ̯
géi	ɡɜɪ̯
Geier	ɡɑɪ̯ɐ
geiereg	ɡɑɪ̯əʁəɕ
Géigend	ɡɜɪ̯ʑənt
Géigendeel	ɡɜɪ̯ʑəndeːl
Géigner	ɡɜɪ̯ʑnɐ
géint	ɡɜɪ̯nt
géintiwwer	ɡɜɪ̯ndivɐ
Geisel	ɡɑɪ̯zəl
Gejäiz	ɡəʑæːɪ̯t͡s
gejirimiris	ɡəʑiʁimiʁis
gekréngelt	ɡəkʁeŋəlt
Gelänner	ɡəlænɐ
Geld	ɡælt
Geleeënheet	ɡəleːənheːt
geléierte	ɡəlɜɪ̯ɐtə
geléierten	ɡəlɜɪ̯ɐtən
gelldir	ɡældiɐ̯
gëlle	ɡələ
gëllen	ɡələn
gelunge	ɡəluŋə
gelungen	ɡəluŋən
Geméis	ɡəmɜɪ̯s
gemeng	ɡəmæŋ
gemittlech	ɡəmitləɕ
Genéck	ɡənek
genee	ɡəneː
genéiere	ʒənɜɪ̯əʁə
genéieren	ʒənɜɪ̯əʁən
genéisse	ɡənɜɪ̯sə
genéissen	ɡənɜɪ̯sən
Generique	ʒeːneʁik
genn	ɡæn
genoss	ɡənos
gënschteg	ɡənʃtəɕ
genuch	ɡənuχ
genug	ɡənuχ
Geographie	ʒeːoɡʁɑfiː
geometer	ʒeːomeːtɐ
Gepäck	ɡəpæk
Gérant	ʒeːʁɑ̃ː
gerechterweis	ɡəʁæɕtɐwɑɪ̯s
géréiere	ʒeːʁɜɪ̯əʁə
géréieren	ʒeːʁɜɪ̯əʁən
gerënne	ɡəʁənə
gerënnen	ɡəʁənən
geriicht	ɡəʁiːɕt
geroch	ɡəʁoχ
gerode	ɡəʁoːdə
geroden	ɡəʁoːdən
Gerücht	ɡəʁyɕt
Geschäft	ɡəʃæft
geschäftlech	ɡəʃæftləɕ
Geschäftsfra	ɡəʃæft͡sfʁaː
Geschäftsmann	ɡəʃæft͡smɑn
geschéckerlech	ɡəʃekɐləɕ
gescheet	ɡəʃeːt
geschéie	ɡəʃɜɪ̯ə
geschéien	ɡəʃɜɪ̯ən
gescheit	ɡəʃɑɪ̯t
gescheitheet	ɡəʃɑɪ̯theːt
geschicht	ɡəʃiɕt
Geschir	ɡəʃiɐ̯
Geschmaach	ɡəʃmaːχ
gëschter	ɡəʃtɐ
geschützt	ɡəʃyt͡st
Geschwätz	ɡəʃwæt͡s
geschwë	ɡəʃwə
geschwënn	ɡəʃwən
Gesellschaft	ɡəsælʃɑft
gesetz	ɡəzæt͡s
gesi	ɡəzi
Gesiicht	ɡəziːɕt
gesinn	ɡəzin
gesond	ɡəzont
Gesondheet	ɡəzontheːt
gespaart	ɡəʃpaːʁt
Gespär	ɡəʃpɛːʁ
Gespenst	ɡəʃpænst
Gespréich	ɡəʃpʁɜɪ̯ɕ
gespréicheg	ɡəʃpʁɜɪ̯ɕəɕ
Gest	ʒæst
geständnes	ɡəʃtæntnəs
Gestank	ɡəʃtɑŋk
geste	ʒæst
gestë	ʒæstə
Gestell	ɡəʃtæl
gesträift	ɡəʃtʁæːɪ̯ft
Gestrëpp	ɡəʃtʁəp
getëppelt	ɡətəpəlt
gette	ɡætə
getten	ɡætən
Gewalt	ɡəvɑlt
Gewan	ɡəvaːn
gewanne	ɡəvɑnə
gewannen	ɡəvɑnən
gewei	ɡəvɑɪ̯
gewéinlech	ɡəvɜɪ̯nləɕ
gewësse	ɡəvəsə
gewëssen	ɡəvəsən
gewëssenhaft	ɡəvəsənhɑft
Gewëssheet	ɡəvəsheːt
Gewier	ɡəviɐ̯
gewierweg	ɡəviɐ̯vəɕ
gewierwegkeet	ɡəviɐ̯vəɕkeːt
Gewierz	ɡəviɐ̯t͡s
Gewiicht	ɡəviːɕt
Gewulls	ɡəvuls
Gewunnecht	ɡəvunəɕt
Gezei	ɡət͡sɑɪ̯
gi	ɡi
gidd	ɡit
Giedel	ɡiə̯dəl
giedlech	ɡiə̯dləɕ
giel	ɡiə̯l
gielzecht	ɡiə̯lt͡səɕt
gielzeg	ɡiə̯lt͡səɕ
gierkse	ɡiɐ̯ksə
gierksen	ɡiɐ̯ksən
Giewel	ɡiə̯vəl
Gilet	ʒileː
ginn	ɡin
Gips	ɡips
gipser	ɡipsɐ
Giraff	ʒiʁɑf
girland	ɡiʁlɑnt
Giss	ɡis
Gitar	ɡitaːʁ
glace	ɡlɑs
Glach	ɡlɑχ
gläich	ɡlæːɪ̯ɕ
Glas	ɡlaːs
glaspabeier	ɡlaːspɑbɑɪ̯ɐ
glat	ɡlaːt
Glatz	ɡlɑt͡s
Glawen	ɡlaːvən
Gléck	ɡlek
glécke	ɡlekə
glécken	ɡlekən
glécklech	ɡlekləɕ
gléckwonsch	ɡlekvonʃ
gleewe	ɡleːvə
gleeweg	ɡleːvəɕ
gleewen	ɡleːvən
Gleis	ɡlɑɪ̯s
glënnere	ɡlənɐə
glënneren	ɡlənɐən
glëtsche	ɡlət͡ʃə
glëtscheg	ɡlət͡ʃəɕ
glëtschen	ɡlət͡ʃən
Glidd	ɡlit
gliddeg	ɡlidəɕ
Globus	ɡloːbus
Glous	ɡləʊ̯s
goe	ɡoːə
goen	ɡoːən
gold	ɡolt
Goldfësch	ɡoltfəʃ
Golf	ɡolf
gomm	ɡom
Gonscht	ɡonʃt
Gorilla	ɡoʁilaː
Gott	ɡot
gottseidank	ɡot͡sɑɪ̯dɑŋk
goudron	ɡudʁɑ̃ː
goungen	ɡəʊ̯ŋən
goungs	ɡəʊ̯ŋs
goungt	ɡəʊ̯ŋt
goureg	ɡəʊ̯ʁəɕ
goût	ɡuː
grad	ɡʁaːt
graf	ɡʁaːf
graff	ɡʁɑf
gräife	ɡʁæːɪ̯fə
gräifen	ɡʁæːɪ̯fən
gräisslech	ɡʁæːɪ̯sləɕ
Gramm	ɡʁɑm
grand	ɡʁɑ̃ː
granzeg	ɡʁɑnt͡səɕ
Grapp	ɡʁɑp
gras	ɡʁaːs
gratis	ɡʁaːtis
gratuléiere	ɡʁɑtulɜɪ̯əʁə
gratuléieren	ɡʁɑtulɜɪ̯əʁən
grausam	ɡʁɑʊ̯saːm
gravéiere	ɡʁɑvɜɪ̯əʁə
gravéieren	ɡʁɑvɜɪ̯əʁən
greef	ɡʁeːf
greeze	ɡʁeːt͡sə
greezen	ɡʁeːt͡sən
Grëff	ɡʁəf
gréisst	ɡʁɜɪ̯st
grell	ɡʁæl
grëndlech	ɡʁəndləɕ
gréng	ɡʁeŋ
gréngelzeg	ɡʁeŋəlt͡səɕ
grënne	ɡʁənə
grënnen	ɡʁənən
Grenz	ɡʁænt͡s
griichesch	ɡʁiːɕəʃ
grille	ɡʁilə
Grillen	ɡʁilən
grimass	ɡʁimɑs
Grimmel	ɡʁiməl
Grinse	ɡʁinzə
grinsen	ɡʁinzən
Gripp	ɡʁip
gro	ɡʁoː
groelzeg	ɡʁoːəlt͡səɕ
grog	ɡʁok
grommele	ɡʁomələ
grommelen	ɡʁomələn
Gromper	ɡʁompɐ
Gromperenzalot	ɡʁompəʁənt͡sɑloːt
gromperepurée	ɡʁompəʁəpyːʁeː
Grond	ɡʁont
Grondwaasser	ɡʁontvaːsɐ
Gronn	ɡʁon
grossist	ɡʁosist
grott	ɡʁot
groupe	ɡʁup
grouss	ɡʁəʊ̯s
groussaarteg	ɡʁəʊ̯zaːʁtəɕ
Grousseltere	ɡʁəʊ̯zæltəʁə
Grousselteren	ɡʁəʊ̯zæltəʁən
Groussgaass	ɡʁəʊ̯sɡaːs
Groussherzog	ɡʁəʊ̯shɛʁt͡soːχ
Groussherzogin	ɡʁəʊ̯shɛʁt͡soːɡin
groussjäreg	ɡʁəʊ̯sjɛːʁəɕ
grued	ɡʁuə̯t
Gruef	ɡʁuə̯f
gruewe	ɡʁuə̯və
gruewen	ɡʁuə̯vən
grujeleg	ɡʁuʒələɕ
Grupp	ɡʁup
gruppéiere	ɡʁupɜɪ̯əʁə
gruppéieren	ɡʁupɜɪ̯əʁən
guckucksblumm	ɡukuksblum
gued	ɡuə̯t
guergel	ɡuə̯ʑəl
guert	ɡuɐt
Guichet	ɡiʃeː
Guidë	ɡiːdə
guide	ɡiːt
Guiden	ɡiːdən
gumm	ɡum
Gummi	ɡumi
güterzuch	ɡyːtɐt͡suχ
gutt	ɡut
guttaarteg	ɡudaːʁtəɕ
guttheesche	ɡutheːʃə
guttheeschen	ɡutheːʃən
Guttheet	ɡutheːt
Haapt	haːpt
Haaptsaach	haːpt͡saːχ
haaptsächlech	haːpt͡sæɕləɕ
Haaptstad	haːpt͡ʃtaːt
haart	haːʁt
Haarz	haːʁt͡s
Haascht	haːʃt
Haass	haːs
haasse	haːsə
haassen	haːsən
hae	haːə
haen	haːən
Häerz	hɛːɐt͡s
häerzche	hɛːɐt͡sjə
häerzchen	hɛːɐt͡sjən
häerzeg	hɛːɐt͡səɕ
häerzi	hɛːɐt͡siː
häerzkrank	hɛːɐt͡skʁɑŋk
Hafe	haːfə
Hafen	haːfən
Haff	hɑf
Haifësch	hɑɪ̯fəʃ
häip	hæːɪ̯p
Haische	hɑɪ̯sjə
Haischen	hɑɪ̯sjən
hale	haːlə
halen	haːlən
Häll	hæl
hall	hɔːl
hallef	hɑləf
Hallefnuecht	hɑləfnuə̯ɕt
hallefstonn	hɑləfʃton
hallem	hɑləm
Hällewull	hæləvul
Hals	hɑls
Halschent	hɑlʃənt
halswéi	hɑlsvɜɪ̯
halt	hɑlt
halwe	hɑlvə
halwen	hɑlvən
halwer	hɑlvɐ
Ham	haːm
Hambier	hɑmbiɐ̯
Hamburger	hɑmbuʁɡɐ
hämmche	hæmɕə
hämmchen	hæmɕən
Hammel	hɑməl
hämmelfleesch	hæməlfleːʃ
hampelmann	hɑmpəlmɑn
Hamster	hɑmstɐ
hamstere	hɑmstəʁə
hamsteren	hɑmstəʁən
hand	hɑnt
Handduch	hɑntduχ
handele	hɑndələ
handelen	hɑndələn
Handgelenk	hɑntɡəlæŋk
Händler	hændlɐ
Händsch	hænt͡ʃ
Handschelle	hɑnt͡ʃælə
Handschellen	hɑnt͡ʃælən
Handwierker	hɑntviɐ̯kɐ
Handwierksgeschir	hɑntviɐ̯ksɡəʃiɐ̯
hänk	hæŋk
hänke	hæŋkə
hänken	hæŋkən
hanne	hɑnə
hannelaanscht	hɑnəlaːnʃt
hannen	hɑnən
hannendrun	hɑnəndʁun
Hannergrond	hɑnɐɡʁont
hannert	hɑnɐt
hannerwands	hɑnɐvɑnt͡s
hannerwenneg	hɑnɐvænəɕ
hannerzeg	hɑnɐt͡səɕ
hännes	hænəs
Happ	hɑp
har	haːʁ
Här	hɛːʁ
Harespel	haːʁæspəl
haseleg	hɑzələɕ
haule	hæːʊ̯lə
haulen	hæːʊ̯lən
haus	hæːʊ̯s
Hausdéiere	hæːʊ̯sdɜɪ̯əʁə
Hausdéieren	hæːʊ̯sdɜɪ̯əʁən
Hausdier	hæːʊ̯sdiɐ̯
Hausfra	hæːʊ̯sfʁaː
hausschlëssel	hæːʊ̯sʃləsəl
haut	hæːʊ̯t
haut	hɑʊ̯t
hautdesdaags	hɑʊ̯təsdaːχs
héchstens	hekstəns
Heck	hæk
hee	heː
heed	heːt
heefeg	heːfəɕ
heehapp	heːhɑp
heekele	heːkələ
heekelen	heːkələn
Heel	heːl
heem	heːm
heemele	heːmələ
heemelen	heːmələn
heemfuere	heːmfuə̯ʁə
heemfueren	heːmfuə̯ʁən
heemgoe	heːmɡoːə
heemgoen	heːmɡoːən
heemkomme	heːmkomə
heemkommen	heːmkomən
heemlech	heːmləɕ
heepst	heːpst
hees	heːs
heesche	heːʃə
Heeschemann	heːʃəmɑn
heeschen	heːʃən
Heesprénger	heːʃpʁeŋɐ
hëff	həf
Heft	hæft
hei	hɑɪ̯
heiansdo	hɑɪ̯ɑnsdoː
heibanne	hɑɪ̯bɑnə
heibannen	hɑɪ̯bɑnən
heibausse	hɑɪ̯bæːʊ̯sə
heibaussen	hɑɪ̯bæːʊ̯sən
héich	hɜɪ̯ɕ
héicht	hɜɪ̯ɕt
héiere	hɜɪ̯əʁə
héieren	hɜɪ̯əʁən
héierenk	hɜɪ̯əʁeŋk
heifir	hɑɪ̯fiɐ̯
héiflech	hɜɪ̯fləɕ
Héiflechkeet	hɜɪ̯fləɕkeːt
heihin	hɑɪ̯hin
heizkierper	hɑɪ̯t͡skiə̯pɐ
Heizung	hɑɪ̯t͡suŋ
Helikopter	helikoptɐ
hell	hæl
hëllef	hələf
hëllefe	hələfə
hëllefen	hələfən
helleg	hæləɕ
hellewech	hæləvæɕ
Helm	hælm
hëlze	həlt͡sə
hëlzen	həlt͡sən
hemmung	hæmuŋ
héngerdéif	heŋɐdɜɪ̯f
héngerjuck	heŋɐʑuk
henker	hæŋkɐ
Hënner	hənɐ
hënnere	hənəʁə
hënneren	hənəʁən
hënnescht	hənəʃt
hënt	hənt
herno	hɛːʁnoː
Herrgott	hɛːʁɡot
Herrgottsfréi	hɛːʁɡot͡sfʁɜɪ̯
Hetz	hæt͡s
hëtze	hət͡sə
hëtzen	hət͡sən
Hëtzt	hət͡st
Hex	hæks
Hexerei	hæksəʁɑɪ̯
Hick	hik
Hickecht	hikəɕt
hidde	hidə
hidden	hidən
hie	hiə̯
hiecht	hiːəɕt
hiefamm	hiːəvɑm
Hiel	hiə̯l
hielänner	hiə̯lænɐ
Hiem	hiə̯m
hiemche	hiə̯mɕə
hiemchen	hiə̯mɕən
hien	hiə̯n
hier	hiɐ̯
Hierk	hiɐ̯k
hierkomme	hiɐ̯komə
hierkommen	hiɐ̯komən
Hierscht	hiɐ̯ʃt
hiert	hiɐ̯t
hieselnoss	hiə̯səlnos
hieselter	hiə̯zəltɐ
hiewe	hiə̯və
Hiewel	hiə̯vəl
hiewen	hiə̯vən
hifuere	hifuə̯ʁə
hifueren	hifuə̯ʁən
hikomme	hikomə
hikommen	hikomən
hileeën	hileːən
him	him
Himmel	himəl
himmelblo	himəlbloː
himmlesch	himləʃ
hinne	hinə
hinnen	hinən
Hinsicht	hinziɕt
hippe	hipə
hippen	hipən
hir	hiɐ̯
Hirsch	hiʁʃ
hirschuel	hiɐ̯ʃuə̯l
Hisiicht	hiziːɕt
histelle	hiʃtælə
histellen	hiʃtælən
Hiwwel	hivəl
Hochzäit	hoχt͡sæːɪ̯t
Hochzäitsdag	hoχt͡sæːɪ̯t͡sdaːχ
Hocker	hokɐ
Hoer	hoːɐ
hoerbiischt	hoːɐbiːʃt
hoereg	hoːəʁəɕ
hoffe	hofə
hoffen	hofən
hoffentlech	hofəntləɕ
Hoffnung	hofnuŋ
Holland	holɑnt
hollännesch	holænəʃ
Holz	holt͡s
holzbock	holt͡sbok
Homard	homaːʁ
Hond	hont
hondsfrieme	hont͡sfʁiə̯mə
hondsfriemen	hont͡sfʁiə̯mən
hondsfriesse	hont͡sfʁiə̯sə
hondsfriessen	hont͡sfʁiə̯sən
hondsgewéinlech	hont͡sɡəvɜɪ̯nləɕ
hondshaische	hont͡shɑɪ̯sjə
hondshaischen	hont͡shɑɪ̯sjən
hondsléngt	hont͡sleŋt
Hong	hoŋ
Honger	hoŋɐ
hongereg	hoŋəʁəɕ
honnert	honɐt
Hörer	høːʁɐ
Hotel	oːtæl
Houer	həʊ̯ɐ
Houfert	həʊ̯fɐt
houfreg	həʊ̯fʁəɕ
houscht	həʊ̯ʃt
houschte	həʊ̯ʃtə
houschten	həʊ̯ʃtən
housecker	həʊ̯sekɐ
housse	hus
hu	hu
huddele	hudələ
huddelen	hudələn
huel	huə̯l
huele	huə̯lə
huelen	huə̯lən
huerele	huə̯ʁələ
huerelen	huə̯ʁələn
huerteg	huɐtəɕ
hues	huə̯s
Huesenziwwi	huə̯sənt͡siviː
huewer	huə̯vɐ
huewerbräi	huə̯vɐbʁæːɪ̯
Huff	huf
Hummer	humɐ
hummere	huməʁə
hummeren	huməʁən
Humpe	humpə
Humpen	humpən
humus	huːmus
hunn	hun
Hunneg	hunəɕ
huppe	hupə
huppen	hupən
hutt	hut
huwwel	huvəl
huwwele	huvələ
huwwelen	huvələn
huwwelspoun	huvəlʃpəʊ̯n
Iddi	idiː
iech	iə̯ɕ
Ielebou	iə̯ləbəʊ̯
ier	iɐ̯
ierbes	iɐ̯bəs
ierflech	iɐ̯fləɕ
Ierfschaft	iɐ̯fʃɑft
iergend	iɐ̯ʑənt
iergendwou	iɐ̯ʑəntvəʊ̯
Ierger	iɐ̯ʑɐ
iergere	iɐ̯ʑəʁə
iergeren	iɐ̯ʑəʁən
iergerlech	iɐ̯ʑɐləɕ
Iertum	iɐ̯tum
Ierwe	iɐ̯və
ierwen	iɐ̯vən
ierz	iɐ̯t͡s
Iesel	iə̯zəl
iesse	iə̯sə
Iessekascht	iə̯sekɑʃt
iessen	iə̯sən
iesses	iə̯səs
iesswuere	iə̯svuə̯ʁə
Iesswueren	iə̯svuə̯ʁən
iesszëmmer	iə̯st͡səmɐ
iewel	iə̯vəl
iewescht	iə̯vəʃt
ieweschte	iə̯vəʃtə
ieweschten	iə̯vəʃtən
Igel	iɡəl
ignoréiere	iɲoʁɜɪ̯əʁə
ignoréieren	iɲoʁɜɪ̯əʁən
Illusioun	ilusjəʊ̯n
illustréiert	ilustʁɜɪ̯ɐt
immens	imæns
impfe	imp͡fə
impfen	imp͡fən
Impfung	imp͡fuŋ
Import	impɔʁt
Indianer	indiaːnɐ
infam	infaːm
Infinitiv	infinitiːf
Infirmier	ɛ̃ːfiʁmjeː
Informatik	infɔʁmaːtik
Ingenieur	ɛ̃ːʒənjœːʁ
Insekt	inzækt
Insel	inzəl
installateur	ɛ̃ːstɑlɑtœːʁ
Instanz	instɑnt͡s
Int	int
intche	int͡ɕə
intchen	int͡ɕən
interview	intɛʁvjuː
intim	intiːm
intressant	intʁæsɑnt
Intressi	intʁæsi
inversioun	invɛʁzjəʊ̯n
Invitatioun	ɛ̃ːvitɑsjəʊ̯n
invitéiere	ɛ̃ːvitɜɪ̯əʁə
invitéieren	ɛ̃ːvitɜɪ̯əʁən
ire	iːʁə
iren	iːʁən
Italie	itaːliə̯
italien	itaːliə̯n
italienesch	itɑlieːnəʃ
iwregens	ivʁəʑəns
iwwel	ivəl
iwwer	ivɐ
iwwerall	ivəʁɑl
iwwerbake	ivɐbaːkə
iwwerbaken	ivɐbaːkən
Iwwerbléck	ivɐblek
iwwerdeems	ivɐdeːms
iwwerdreiwe	ivɐdʁɑɪ̯və
iwwerdreiwen	ivɐdʁɑɪ̯vən
iwwerdroe	ivɐdʁoːə
iwwerdroen	ivɐdʁoːən
iwwerenee	ivəʁəneː
iwwereneen	ivəʁəneːn
iwwerfale	ivɐfaːlə
iwwerfalen	ivɐfaːlən
Iwwerfloss	ivɐflos
iwwerfuere	ivɐfuə̯ʁə
iwwerfueren	ivɐfuə̯ʁən
iwwergi	ivɐɡi
iwwerginn	ivɐɡin
iwwerhaapt	ivɐhaːpt
iwwerhuele	ivɐhuə̯lə
iwwerhuelen	ivɐhuə̯lən
iwwerleeën	ivɐleːən
iwwerliewe	ivɐliə̯və
iwwerliewen	ivɐliə̯vən
iwwermar	ivɐmaːʁ
iwwermuer	ivɐmuːɐ
iwwerrasche	ivəʁɑʃə
iwwerraschen	ivəʁɑʃən
Iwwerraschung	ivəʁɑʃuŋ
iwwerreeche	ivəʁeːɕə
iwwerreechen	ivəʁeːɕən
iwwerrenne	ivəʁænə
iwwerrennen	ivəʁænən
iwwerriede	ivəʁiə̯də
iwwerrieden	ivəʁiə̯dən
Iwwerschrëft	ivɐʃʁəft
Iwwerschwemmung	ivɐʃwæmuŋ
iwwersetze	ivɐsæt͡sə
iwwersetzen	ivɐsæt͡sən
Iwwersiicht	ivɐziːɕt
iwwersprange	ivɐʃpʁɑŋə
iwwersprangen	ivɐʃpʁɑŋən
Iwwerstonn	ivɐʃton
iwwert	ivɐt
iwwerustrengung	ivɐuʃtʁæŋuŋ
iwwerwaache	ivɐvaːχə
iwwerwaachen	ivɐvaːχən
iwwerzeege	ivɐt͡seːʑə
iwwerzeegen	ivɐt͡seːʑən
Iwwerzeegung	ivɐt͡seːʑuŋ
ja	jaː
Jackett	ʒɑkæt
jäize	ʑæːɪ̯t͡sə
jäizeg	ʑæːɪ̯t͡səɕ
jäizen	ʑæːɪ̯t͡sən
jalous	ʒɑləʊ̯s
jalousheet	ʒɑləʊ̯sheːt
Jalousie	ʒɑluziː
Januar	ʑɑnuaːʁ
jarnéier	ʒaːʁnɜɪ̯ɐ
jatte	ʒɑt
jauwe	ʑɑʊ̯və
jauwen	ʑɑʊ̯vən
jeans	d͡ʒiːns
Jeeër	jeɐ
jeeërlech	jeːɐləɕ
jéimere	ʑɜɪ̯məʁə
jéimeren	ʑɜɪ̯məʁən
Jelli	ʒeli
jéngelche	ʑeŋəlɕə
Jéngelchen	ʑeŋəlɕən
jéngste	ʑeŋstə
jéngsten	ʑeŋstən
jick	ʑik
jicke	ʑikə
jicken	ʑikən
jiddefalls	ʑidəfɑls
jidder	ʑidɐ
jidderee	ʑidəʁeː
jiddereen	ʑidəʁeːn
jiddweree	ʑidfəʁeː
jiddwereen	ʑidfəʁeːn
jilli	ʒiliː
jinsseg	ʑinsəɕ
jo	joː
Joe	joːə
joen	joːən
joer	joːɐ
Joffer	jofɐ
jogge	d͡ʒoɡə
joggen	d͡ʒoɡən
jogurth	juɡuʁt
jong	joŋ
Jonggesell	joŋɡəzæl
jongleur	ʒɑ̃ːɡlœːʁ
jonk	joŋk
Jor	joːʁ
jorelaang	joːʁelaːŋ
Jorhonnert	joːʁhonɐt
joshgun	joʃɡun
Journalist	ʒuʁnɑlist
Judd	jut
Judo	juːdoː
Juegd	juə̯ɕt
Jugend	juːʁənt
Jugendherberg	juːʁənthɛːɐbɛʁɕ
Juli	ʑuːli
Juni	ʑuːni
Jupe	ʒyp
jupon	ʒypɑ̃ː
jus	ʒyː
just	ʒust
ka	kɑ
Kaart	kaːʁt
Kabel	kaːbəl
Kabes	kaːbəs
Kach	kɑχ
Kachbuch	kɑχbuχ
kachcours	kɑχkuːɐ
kachdëppe	kɑχdəpə
Kachdëppen	kɑχdəpən
käche	kæɕə
kache	kɑχə
kachegliddeg	kɑχəɡlidəɕ
Kächen	kæɕən
kachen	kɑχən
Kachmaschinn	kɑχmɑʃin
kackelack	kɑkəlɑk
kackuett	kɑkwæt
Kadaver	kɑdaːvɐ
Kader	kaːdɐ
käerche	kɛːɐɕə
käerchen	kɛːɐɕən
Käerz	kɛːɐt͡s
kaf	kaːf
kafe	kaːfə
Käfeg	kɛːfəɕ
kafen	kaːfən
Kaffi	kɑfiː
kaffisbiz	kɑfiːsbiːt͡s
kaffisläffelche	kɑfiːslæfəlɕə
kaffisläffelchen	kɑfiːslæfəlɕən
kaffismille	kɑfiːsmilə
kaffismillen	kɑfiːsmilən
käiche	kæːɪ̯ɕə
käichen	kæːɪ̯ɕən
Kakao	kɑkɑoː
kal	kaːl
Kalbass	kɑlbɑs
kalbliddeg	kaːlblidəɕ
Kalenner	kɑlænɐ
kall	kɑl
Kallef	kɑləf
kalleffleesch	kɑləffleːʃ
kallefskotlett	kɑləfskotlæt
kallek	kɑlek
Kalzong	kɑlt͡soŋ
Kamäin	kɑmæːɪ̯n
Kaméidi	kɑmɜɪ̯di
kaméil	kɑmɜɪ̯l
Kamell	kɑmæll
Kamera	kɑmeːʁaː
kämme	kæmə
kämmen	kæmən
kammoud	kɑməʊ̯t
kammoudheet	kɑməʊ̯theːt
kamomill	kɑmomil
kamp	kɑmp
Kampf	kɑmp͡f
kämpfe	kæmp͡fə
kämpfen	kæmp͡fən
Kämpfer	kæmp͡fɐ
kan	kaːn
Kanal	kɑnaːl
kanarievull	kɑnaːʁiə̯ful
kand	kɑnt
Kanddaf	kɑntdaːf
kanéngche	kɑneŋɕə
Kanéngchen	kɑneŋɕən
Känguruh	kæŋɡuʁuː
kannereg	kɑnəʁəɕ
Kannerkutsch	kɑnɐkut͡ʃ
Kannerzëmmer	kɑnɐt͡səmɐ
Kantin	kɑntin
Kap	kaːp
kapéiere	kɑpɜɪ̯əʁə
kapéieren	kɑpɜɪ̯əʁən
kaper	kaːpɐ
kapëtche	kɑpət͡ɕə
kapëtchen	kɑpət͡ɕən
Kapitel	kɑpitəl
kapp	kɑp
kappkësse	kɑpkəsə
Kappkëssen	kɑpkəsən
kappsprong	kɑpʃpʁoŋ
Kappwéi	kɑpvɜɪ̯
kappzich	kɑpt͡siɕ
Kar	kaːʁ
Kär	kɛːʁ
karaff	kɑʁɑf
Karate	kɑʁaːteː
karblumm	kaːʁblum
karéiert	kɑʁɜɪ̯ɐt
Kärel	kɛːʁəl
kärgesond	kɛːʁɡəzont
karmell	kɑʁmæl
karo	kaːʁoː
Karschnatz	kaːʁʃnɑt͡s
Kartong	kɑχtoŋ
kartongskëscht	kɑχtoŋskəʃt
kasär	kɑzɛːʁ
käscht	kæʃt
kascht	kɑʃt
kaschte	kɑʃtə
Käschtebam	kæʃtəbaːm
kaschten	kɑʃtən
kassett	kɑsæt
kassroll	kɑsʁol
Katastrof	kɑtɑstʁoːf
kathoulesch	kɑtəʊ̯ləʃ
Katze	kɑt͡sə
katzen	kɑt͡sən
kaum	kæːʊ̯m
kauzekapp	kæːʊ̯t͡səkɑp
Kaviar	kɑviaːʁ
kaweechelche	kɑveːɕəlɕə
Kaweechelchen	kɑveːɕəlɕən
Kaz	kaːt͡s
këddele	kədələ
këddeleg	kədələɕ
këddelen	kədələn
kee	keː
Keefer	keːfɐ
Keel	keːl
keeleklatz	keːləklɑt͡s
Keelt	keːlt
keen	keːn
Kees	keːs
Keeser	keːzɐ
Keess	keːs
kéidreck	kɜɪ̯dʁæk
kéier	kɜɪ̯ɐ
keime	kɑɪ̯mə
keimen	kɑɪ̯mən
Kéis	kɜɪ̯s
kéisecker	kɜɪ̯sekɐ
kéisrapp	kɜɪ̯sʁɑp
kéistupp	kɜɪ̯ʃtup
Keller	kælɐ
kellertrap	kælɐtʁaːp
Këndche	kənt͡ɕə
Këndchen	kənt͡ɕən
keng	kæŋ
kéng	keŋ
kénge	keŋə
kéngen	keŋən
kéngheet	keŋheːt
kënn	kən
kenne	kænə
kënne	kənə
kënneg	kənəɕ
kënnege	kənəʑə
kënnegen	kənəʑən
kennen	kænən
kënnen	kənən
Kennschaft	kænʃɑft
kënschtlech	kənʃtləɕ
Kënschtler	kənʃtlɐ
Këscht	kəʃt
Kësse	kəsə
këssen	kəsən
Kette	kætə
Ketten	kætən
Kiche	kiɕə
kichebriet	kiɕəbʁiə̯t
Kichelche	kiɕəlɕə
Kichelchen	kiɕəlɕən
Kichemesser	kiɕəmæsɐ
Kichen	kiɕən
Kichendësch	kiɕəndəʃ
kichenduch	kiɕənduχ
kicheschaf	kiɕəʃaːf
kichestull	kiɕəʃtul
kichewo	kiɕəvoː
kickele	kikələ
kickelen	kikələn
kidnappéiere	kitnɑpɜɪ̯əʁə
kidnappéieren	kitnɑpɜɪ̯əʁən
kierb	kiɐ̯p
kierbiischt	kiɐ̯biːʃt
Kierch	kiɐ̯ɕ
kiere	kiɐ̯ʁə
kieren	kiɐ̯ʁən
kierfche	kiɐ̯fɕə
kierfchen	kiɐ̯fɕən
Kierfecht	kiɐ̯fəɕt
Kiermes	kiɐ̯məs
Kierper	kiɐ̯pɐ
kierze	kiɐ̯t͡sə
kierzen	kiɐ̯t͡sən
kierzlech	kiɐ̯t͡sləɕ
Kiewerlek	kiə̯vɐlek
Kiischt	kiːʃt
kiischtche	kiːʃt͡ɕə
kiischtchen	kiːʃt͡ɕən
kiischtebam	kiːʃtəbaːm
kill	kil
kille	kilə
killen	kilən
Kilo	kiloː
kilometer	kilomeːtɐ
king	kiŋ
kinge	kiŋə
kingen	kiŋən
Kinnek	kinek
Kinnigin	kiniɡin
Kino	kinoː
kippe	kipə
kippen	kipən
kiselstee	kizəlʃteː
kiselsteen	kizəlʃteːn
Kitsch	kit͡ʃ
kitscheg	kit͡ʃəɕ
kiwwel	kivəl
Klaatsch	klaːt͡ʃ
klaatsche	klaːt͡ʃə
klaatschen	klaːt͡ʃən
klabbere	klɑbəʁə
klabberen	klɑbəʁən
Klack	klɑk
Klackespill	klɑkəʃpil
klam	klaːm
klamme	klɑmə
klammen	klɑmən
klape	klaːpə
klapen	klaːpən
klappbar	klɑpbaːʁ
klappe	klɑpə
klappen	klɑpən
Kläpperei	klæpəʁɑɪ̯
klapplued	klɑpluə̯t
Klarinett	klɑʁinæt
Klass	klɑs
klätsche	klæt͡ʃə
klätschen	klæt͡ʃən
Klatz	klɑt͡s
Klatzkapp	klɑt͡skɑp
klatzkäppeg	klɑt͡skæpəɕ
klaue	klɑʊ̯ə
klauen	klɑʊ̯ən
klauschter	klæːʊ̯ʃtɐ
Kleed	kleːt
kleedche	kleːt͡ɕə
kleedchen	kleːt͡ɕən
kleederbigel	kleːdɐbiʑəl
kleederbiischt	kleːdɐbiːʃt
Kleedergeschäft	kleːdɐɡəʃæft
Kleederschaf	kleːdɐʃaːf
Kleedung	kleːduŋ
Kleesche	kleːsjə
Kleeschen	kleːsjən
kleesper	kleːspɐ
Kléi	klɜɪ̯
kleng	klæŋ
klénge	kleŋə
Klengegkeet	klæŋəɕkeːt
kléngen	kleŋən
klenglech	klæŋləɕ
Klensch	klænʃ
klëppelsteng	kləpəlʃtæŋ
Klibber	klibɐ
Klima	kliːmaː
Klinik	klinik
klinzeg	klint͡səɕ
klippe	klipə
klippen	klipən
Klo	kloː
kloe	kloːə
kloen	kloːən
kloer	kloːɐ
klomp	klomp
klotere	kloːtəʁə
kloteren	kloːtəʁən
Klouschter	kləʊ̯ʃtɐ
kluck	kluk
Kludder	kludɐ
klunsch	klunʃ
klunschele	klunʃələ
klunschelen	klunʃələn
knabbele	knɑbələ
knabbelen	knɑbələn
knabbere	knɑbəʁə
knabberen	knɑbəʁən
Knache	knɑχə
Knachen	knɑχən
knae	knaːə
knaen	knaːən
knäipche	knæːɪ̯pɕə
knäipchen	knæːɪ̯pɕən
knäipe	knæːɪ̯pə
knäipen	knæːɪ̯pən
knapp	knɑp
Knäpplach	knæplɑχ
knapps	knɑps
Knascht	knɑʃt
knaschteg	knɑʃtəɕ
Knätsch	knæt͡ʃ
knätsche	knæt͡ʃə
knätschen	knæt͡ʃən
knätzele	knæt͡sələ
knätzelen	knæt͡sələn
knausereg	knɑʊ̯zəʁəɕ
knéchele	knəɕələ
knéchelen	knəɕələn
knéckeg	knekəɕ
Knéckjang	knekʒɑŋ
Knéi	knɜɪ̯
Knéie	knɜɪ̯ə
knéien	knɜɪ̯ən
knéischeif	knɜɪ̯ʃɑɪ̯f
Knëppel	knəpəl
Knëppelsteng	knəpəlʃtæŋ
kniddel	knidəl
kniede	kniə̯də
knieden	kniə̯dən
kniff	knif
knippche	knipɕə
Knippchen	knipɕən
knipse	knipsə
knipsen	knipsən
kniwwele	knivələ
kniwwelen	knivələn
knosp	knosp
knoutere	knəʊ̯təʁə
knoutereg	knəʊ̯təʁəɕ
knouteren	knəʊ̯təʁən
knubbeleg	knubələɕ
Knuet	knuə̯t
Knuewelek	knuə̯vəlek
Knupp	knup
knuppe	knupə
knuppen	knupən
Köder	køːdɐ
Koffer	kofɐ
kokett	kokæt
Kolleg	koleːɕ
Kollegin	koleːʑin
Kolonn	kolon
Komerod	koməʁoːt
komesch	koːməʃ
Komiker	koːmikɐ
Komma	komaː
kommandéiere	komɑndɜɪ̯əʁə
kommandéieren	komɑndɜɪ̯əʁən
komme	komə
kommen	komən
Kommissioun	komisjəʊ̯n
komp	komp
Kompass	kompɑs
Kompetenz	kompeːtænt͡s
Kompliment	komplimænt
komplizéiert	komplit͡sɜɪ̯ɐt
komplottéiere	komplotɜɪ̯əʁə
komplottéieren	komplotɜɪ̯əʁən
Komponist	komponist
Konditioun	kondit͡sjəʊ̯n
konfus	konfuːs
konnschaft	konʃɑft
Konscht	konʃt
Konschtwierk	konʃtviɐ̯k
konserv	konzɛʁf
konserven	konzɛʁvən
Konsonant	konzonɑnt
Kont	kont
kontabilitéit	kontɑbilitɜɪ̯t
kontakt	kontɑkt
kontrolléiere	kontʁolɜɪ̯əʁə
kontrolléieren	kontʁolɜɪ̯əʁən
Kontroller	kontʁolɐ
kontrolltuerm	kontʁoltuɐm
kopéiere	kopɜɪ̯əʁə
kopéieren	kopɜɪ̯əʁən
kopi	kopi
Koppel	kopəl
Kopplabunz	koplɑbunt͡s
kork	koχk
koschter	koʃtɐ
koschtere	koʃtəʁə
koschteren	koʃtəʁən
Koseng	kozeŋ
Kostüm	kostym
kotlett	kotlæt
Kotteng	koteŋ
Kou	kəʊ̯
kouert	kəʊ̯ɐt
Koup	kəʊ̯p
Koustall	kəʊ̯ʃtɑl
koz	koːt͡s
kraache	kʁaːχə
kraachen	kʁaːχən
Kraaft	kʁaːft
krabb	kʁɑp
krabbe	kʁɑbə
krabben	kʁɑbən
Kräid	kʁæːɪ̯t
kräijong	kʁæːɪ̯joŋ
kräische	kʁæːɪ̯ʃə
kräischen	kʁæːɪ̯ʃən
kräiz	kʁæːɪ̯t͡s
kräize	kʁæːɪ̯t͡sə
kräizen	kʁæːɪ̯t͡sən
Kräizung	kʁæːɪ̯t͡suŋ
krall	kʁɑll
Kramp	kʁɑmp
Kran	kʁaːn
krank	kʁɑŋk
krankeschwëster	kʁɑŋkəʃwəstɐ
Krankheet	kʁɑŋkheːt
krankheetskeim	kʁɑŋkheːt͡skɑɪ̯m
Kranz	kʁɑnt͡s
krapp	kʁɑp
krappeg	kʁɑpəɕ
krauche	kʁæːʊ̯χə
krauchen	kʁæːʊ̯χən
krausel	kʁɑʊ̯zəl
krauseleg	kʁɑʊ̯zələɕ
Kraut	kʁæːʊ̯t
Krawatt	kʁɑvɑt
kraze	kʁaːt͡sə
krazen	kʁaːt͡sən
kréckele	kʁekələ
kréckelen	kʁekələn
Kreditkaart	kʁeditkaːʁt
Kreemche	kʁeːmɕə
Kreemchen	kʁeːmɕən
Krees	kʁeːs
Kreesch	kʁeːʃ
kregéile	kʁəɡɜɪ̯lə
kregéilen	kʁəɡɜɪ̯lən
kréi	kʁɜɪ̯
kréie	kʁɜɪ̯ə
kréien	kʁɜɪ̯ən
kréiena	kʁɜɪ̯ənaː
kréimer	kʁɜɪ̯mɐ
Kréischel	kʁɜɪ̯ʃəl
kréischelsheck	kʁɜɪ̯ʃəlshæk
krëpeng	kʁəpeŋ
Krëpp	kʁəp
krëppel	kʁəpəl
krëppeleg	kʁəpələɕ
kretsch	kʁæt͡ʃ
krich	kʁiɕ
kriddeleg	kʁidələɕ
Kriibs	kʁiːps
Krimi	kʁimiː
kristall	kʁistɑl
kriten	kʁiːtən
kritiséiere	kʁitizɜɪ̯əʁə
kritiséieren	kʁitizɜɪ̯əʁən
krokodill	kʁokodil
Krom	kʁoːm
kromm	kʁom
Krop	kʁoːp
krou	kʁəʊ̯
Kroun	kʁəʊ̯n
Krunn	kʁun
kruppschank	kʁupʃɑŋk
krut	kʁuːt
kruten	kʁuːtən
Kuch	kuχ
kucke	kukə
kucken	kukən
Kuddelfleck	kudəlflæk
Kueb	kuə̯p
Kuebe	kuə̯bə
Kueben	kuə̯bən
Kueder	kuə̯dɐ
Kuel	kuə̯l
Kuerf	kuɐf
kuerz	kuɐt͡s
kuerze	kuɐt͡sə
kuerzen	kuɐt͡sən
kuerzsichteg	kuɐt͡sziɕtəɕ
Kugel	kuʁəl
kulang	kulɑŋ
Kulisse	kulise
Kulissen	kulisen
Kummer	kumɐ
Künstler	kynstlɐ
Kupplung	kupluŋ
Kur	kuːɐ
kurzschluss	kuɐt͡sʃlus
Kuss	kus
Kuuscht	kuːʃt
kuuschteg	kuːʃtəɕ
Kuuschtert	kuːʃtɐt
Laach	laːχ
laache	laːχə
laachen	laːχən
laang	laːŋ
laanscht	laːnʃt
laanschtkomme	laːnʃtkomə
laanschtkommen	laːnʃtkomən
laascht	laːʃt
labber	lɑbɐ
Lach	lɑχ
lächele	læɕələ
lächelen	læɕələn
lächerlech	læɕɐləɕ
lackele	lɑkələ
lackeleg	lɑkələɕ
lackelen	lɑkələn
laf	laːf
lafe	laːfə
lafen	laːfən
Läffel	læfəl
läffelsgeschir	læfəlsɡəʃiɐ̯
Läich	læːɪ̯ɕ
Läif	læːɪ̯f
läilech	læːɪ̯ləɕ
läinduch	læːɪ̯nduχ
läinzeeche	læːɪ̯nt͡seːɕə
läinzeechen	læːɪ̯nt͡seːɕən
laitue	lɛːty
laitue	lɛːtyː
lämmche	læmɕə
lämmchen	læmɕən
land	lɑnt
lande	lɑndə
landen	lɑndən
Landkaart	lɑntkaːʁt
Landschaft	lɑnt͡ʃɑft
Landstrooss	lɑnt͡ʃtʁoːs
Landung	lɑnduŋ
landwirt	lɑntviʁt
länge	læŋə
längen	læŋən
Längt	læŋt
langust	lɑŋɡust
Langweil	lɑŋvɑɪ̯l
langweile	lɑŋvɑɪ̯lə
langweileg	lɑŋvɑɪ̯ləɕ
langweilen	lɑŋvɑɪ̯lən
Lann	lɑn
Lanz	lɑnt͡s
läppche	læpɕə
Läppchen	læpɕən
läsche	læʃə
läschen	læʃən
lass	lɑs
lassgi	lɑsɡi
lassginn	lɑsɡin
lassgoe	lɑsɡoːə
lassgoen	lɑsɡoːən
lassloosse	lɑsloːsə
lassloossen	lɑsloːsən
lästeg	læstəɕ
Lastik	lɑstik
laude	lɑʊ̯də
lauden	lɑʊ̯dən
Lauer	lɑʊ̯ɐ
lauere	lɑʊ̯əʁə
laueren	lɑʊ̯əʁən
laufbursch	lɑʊ̯fbuʁʃ
Laun	lɑʊ̯n
launesch	lɑʊ̯nəʃ
laus	læːʊ̯s
lauschtere	læːʊ̯ʃtəʁə
lauschteren	læːʊ̯ʃtəʁən
lauter	læːʊ̯tɐ
lautspriecher	læːʊ̯t͡ʃpʁiə̯ɕɐ
Lavabo	lɑvɑboː
Lavendel	lɑvændəl
Lawin	lɑviːn
lecke	lækə
lecken	lækən
lee	leː
leechne	leːɕnə
leechnen	leːɕnən
leed	leːt
leede	leːdə
leeden	leːdən
Leeder	leːdɐ
leeën	leːən
leem	leːm
leeschte	leːʃtə
leeschten	leːʃtən
Leeschtung	leːʃtuŋ
lëfte	ləftə
lëften	ləftən
leide	lɑɪ̯də
leiden	lɑɪ̯dən
Leidenschaft	lɑɪ̯dənʃɑft
leider	lɑɪ̯dɐ
leie	lɑɪ̯ə
léie	lɜɪ̯ə
leien	lɑɪ̯ən
léien	lɜɪ̯ən
Leier	lɑɪ̯ɐ
Léier	lɜɪ̯ɐ
Léierbouf	lɜɪ̯ɐbəʊ̯f
leiere	lɑɪ̯əʁə
léiere	lɜɪ̯əʁə
leieren	lɑɪ̯əʁən
léieren	lɜɪ̯əʁən
Léierin	lɜɪ̯əʁin
léierjong	lɜɪ̯ɐjoŋ
léif	lɜɪ̯f
léift	lɜɪ̯ft
léine	lɜɪ̯nə
léinen	lɜɪ̯nən
léise	lɜɪ̯zə
Léisegeld	lɜɪ̯zəɡælt
léisen	lɜɪ̯zən
léislech	lɜɪ̯sləɕ
Léisung	lɜɪ̯zuŋ
leit	lɑɪ̯t
Leitung	lɑɪ̯tuŋ
léiw	lɜɪ̯f
léiweckelche	lɜɪ̯vækəlɕə
léiweckelchen	lɜɪ̯vækəlɕən
léiwemailche	lɜɪ̯vəmɑɪ̯lɕə
léiwemailchen	lɜɪ̯vəmɑɪ̯lɕən
Lektioun	læksjəʊ̯n
lëmmel	ləməl
lëmmelzeg	ləməlt͡səɕ
léngent	leŋənt
Léngt	leŋt
lénks	leŋks
lënnere	lənəʁə
lënneren	lənəʁən
Lëns	ləns
Leopard	leopaːʁt
Lëppestëft	ləpəʃtəft
lëps	ləps
lescht	læʃt
lëscht	ləʃt
leschte	læʃtə
lëschteg	ləʃtəɕ
leschten	læʃtən
Lëtzebuerg	lət͡səbuɐɕ
lëtzebuerger	lət͡səbuɐjɐ
Lëtzebuergerin	lət͡səbuɐjəʁin
lëtzebuergesch	lət͡səbuɐjəʃ
libell	libæl
liberal	libəʁaːl
librairie	libʁæʁiː
Lidd	lit
liddereg	lidəʁəɕ
Lidderhanes	lidɐhaːnəs
Lieder	liə̯dɐ
liefkuch	liə̯fkuχ
lies	liə̯s
liese	liə̯zə
liesen	liə̯zən
Lieser	liə̯zɐ
liewe	liə̯ve
lieweg	liə̯vəɕ
liewen	liə̯ven
Liewer	liə̯veʁ
liewerkniddel	liə̯veʁknidəl
liewesgeféierlech	liə̯vesɡəfɜɪ̯ɐləɕ
lieweskraaft	liə̯veskʁaːft
liewesmidd	liə̯vesmit
liewesraum	liə̯vesʁæːʊ̯m
Lift	lift
Lige	liʑə
Ligen	liʑən
Ligener	liʑənɐ
Ligestull	liːʑəʃtul
liicht	liːɕt
Liichtegkeet	liːɕtəɕkeːt
Liichtmëssdag	liːɕtməsdaːχ
liichtsënneg	liːɕtzənəɕ
Limonad	limonaːt
Lineal	lineaːl
Liter	litɐ
living	liviŋ
liwwere	livəʁə
liwweren	livəʁən
Liwwerwon	livɐvoːn
lo	loː
Locataire	lokɑtɛːʁ
Loft	loft
Loftballon	loftbɑlɑ̃ː
Lokomotiv	lokomotiːf
lokomotiven	lokomotiːvən
lokomotivführer	lokomotiːffyːʁɐ
Lomp	lomp
long	loŋ
loosse	loːsə
loossen	loːsən
lorberblat	lɔʁbɐblaːt
losange	lozɑ̃ːʃ
Loscht	loʃt
louche	luʃ
Loun	ləʊ̯n
loune	ləʊ̯nə
lounen	ləʊ̯nən
lous	ləʊ̯s
loyer	lwɑjeː
luede	luə̯də
lueden	luə̯dən
Luef	luə̯f
lues	luə̯s
Lupp	lup
lüster	lystɐ
Lut	luːt
lutsch	lut͡ʃ
lutsche	lut͡ʃə
lutschen	lut͡ʃən
Luucht	luːχt
luuchteschalter	luːχtəʃɑltɐ
luusse	luːsə
luusseg	luːsəɕ
luussen	luːsən
luxuriéis	luksuʁjɜɪ̯s
Luxus	luksus
lycée	liseː
ma	mɑ
maache	maːχə
maachen	maːχən
maans	maːns
Maart	maːʁt
Maartplaz	maːʁtplaːt͡s
mächteg	mæɕtəɕ
mackeg	mɑkəɕ
Madame	mɑdɑm
Mäerche	mɛɐɕə
Mäerchen	mɛɐɕən
Mäerder	mɛɐdɐ
mäerderesch	mɛɐdəʁəʃ
Mäerz	mɛɐt͡s
Magnéit	mɑɡnɜɪ̯t
mäifelche	mæːɪ̯fəlɕə
Mäifelchen	mæːɪ̯fəlɕən
maillot	mɑjoː
mäin	mæːɪ̯n
Malaise	mɑlɛːs
malle	mɑl
mam	mɑm
Mama	mɑmaː
manchett	mɑ̃ːʃæt
mandel	mɑndəl
mandele	mɑndələ
mandelen	mɑndələn
manéierlech	mɑnɜɪ̯ɐləɕ
Manktem	mɑŋktəm
mann	mɑn
manner	mɑnɐ
mannerjäreg	mɑnɐjɛːʁəɕ
männlech	mænləɕ
mansard	mɑ̃ːsaːʁ
Mantel	mɑntəl
mantelbriet	mɑntəlbʁiə̯t
Mapp	mɑp
mar	maːʁ
Marber	mɑʁbɐ
Märei	mæʁɑɪ̯
Märel	mɛːʁəl
margréitche	maːʁɡʁɜɪ̯t͡ɕə
margréitchen	maːʁɡʁɜɪ̯t͡ɕən
Marionett	mɑʁionæt
Masch	mɑʃ
Mask	mɑsk
maskéieren	mɑskɜɪ̯əʁən
Mass	mɑs
Massage	mɑsaːʃ
Massaker	mɑsɑkɐ
masseg	mɑsəɕ
masseur	mɑsœːʁ
masseuse	mɑsøːs
mast	mɑst
mastik	mɑstik
masutt	mɑzut
mat	mɑt
matbrénge	mɑtbʁeŋə
matbréngen	mɑtbʁeŋən
matdeele	mɑtdeːlə
matdeelen	mɑtdeːlən
matenee	mɑdəneː
mateneen	mɑdəneːn
Material	mɑteʁjaːl
matgoe	mɑtɡoːə
matgoen	mɑtɡoːən
Mathematik	mɑtemaːtik
mathuele	mɑthuə̯lə
mathuelen	mɑthuə̯lən
Matleed	mɑtleːt
Matrass	mɑtʁɑs
Matrous	mɑtʁəʊ̯s
matschaffe	mɑt͡ʃɑfə
matschaffen	mɑt͡ʃɑfən
matt	mɑt
Mauer	mɑʊ̯ɐ
Maufel	mæːʊ̯fəl
Maulef	mæːʊ̯ləf
Maulkuerf	mæːʊ̯lkuɐf
Maus	mæːʊ̯s
mauséiercheszalot	mɑʊ̯zɜɪ̯ɐɕəst͡sɑloːt
Mécanicien	meːkɑnisjɛ̃ː
mech	məɕ
méchs	məɕs
Méck	mek
meckere	mækəʁə
meckeren	mækəʁən
Medail	mədɑɪ̯l
Medezin	mədət͡sin
Medikament	meːdikɑmænt
mee	meː
Meedche	meːt͡ɕə
Meedchen	meːt͡ɕən
meederchesnumm	meːdɐɕəsnum
Meenung	meːnuŋ
meeréische	meːʁɜɪ̯sjə
meeréischen	meːʁɜɪ̯sjən
meescht	meːʃt
meeschtens	meːʃtəns
meeschter	meːʃtɐ
Meessel	meːsəl
meessele	meːsələ
meesselen	meːsələn
Mehrzahl	meːɐt͡saːl
méi	mɜɪ̯
meide	mɑɪ̯də
meiden	mɑɪ̯dən
méie	mɜɪ̯ə
méien	mɜɪ̯ən
méiglech	mɜɪ̯ʑləɕ
Méiglechkeet	mɜɪ̯ʑləɕkeːt
méiglechst	mɜɪ̯ʑləɕst
Méimaschinn	mɜɪ̯mɑʃin
Méindeg	mɜɪ̯ndəɕ
méindes	mɜɪ̯ndəs
méintlaang	mɜɪ̯ntlaːŋ
méisseg	mɜɪ̯səɕ
Méiw	mɜɪ̯f
méiwe	mɜɪ̯və
méiwen	mɜɪ̯vən
melde	mældə
melden	mældən
Meldung	mælduŋ
mëll	məl
melle	mælə
Mëllech	mələɕ
mëllechquoten	mələɕkwoːtən
mëllechzant	mələɕt͡sɑnt
mellen	mælən
mëller	məlɐ
meloun	mələʊ̯n
mëlz	məlt͡s
member	mɑ̃ːmbɐ
Memberen	mɑ̃ːmbəʁən
mëndlech	məndləɕ
mëndlecht	məndləɕt
meng	meŋ
menge	mæŋə
menge	meŋə
mengem	meŋəm
mengen	mæŋən
mengen	meŋən
menger	meŋɐ
Mënsch	mənʃ
mënschlech	mənʃləɕ
menu	mənyː
menuskaart	mənyːskaːʁt
Mënz	mənt͡s
mer	mɐ
merci	mɛʁsiː
Mësch	məʃ
mësche	məʃə
mëschen	məʃən
mëscht	məʃt
Mëschung	məʃuŋ
message	mæsaːʃ
Mëssbrauch	məsbʁæːʊ̯χ
mëssbrauche	məsbʁæːʊ̯χə
mëssbrauchen	məsbʁæːʊ̯χən
Messer	mæsɐ
mësserfolleg	məzɐfoləɕ
Mëssgeschéck	məsɡəʃek
Mësstraue	məstʁɑʊ̯ə
mësstrauen	məstʁɑʊ̯ən
mësstrauesch	məstʁɑʊ̯əʃ
meter	meːtɐ
Mëtt	mət
Mëtteg	mətəɕ
Mëttegiesse	mətəɕiə̯sə
Mëttegiessen	mətəɕiə̯sən
mëttelméisseg	mətəlmɜɪ̯səɕ
mëttelste	mətəlstə
mëttelsten	mətəlstən
Mëtternuecht	mətɐnuə̯ɕt
mëttes	mətəs
Mëttespaus	mətəspɑʊ̯s
Mëttesrascht	mətəsʁɑʃt
Mëttwoch	mətwoχ
mëttwochs	mətwoχs
Metzler	mæt͡slɐ
Metzlerei	mæt͡sləʁɑɪ̯
miaue	miːɑʊ̯ə
miauen	miːɑʊ̯ən
midd	mit
Middegkeet	midəɕkeːt
Miel	miə̯l
mier	miɐ̯
mierf	miɐ̯f
mierke	miɐ̯kə
mierken	miɐ̯kən
mierschwéngche	miɐ̯ʃweŋɕə
mierschwéngchen	miɐ̯ʃweŋɕən
mierstär	miɐ̯ʃtɛːʁ
migrän	miɡʁɛːn
miissche	miːsjə
miisschen	miːsjən
miissercher	miːsɐɕɐ
Mikro	mikʁoː
mille	milə
Millen	milən
Minister	ministɐ
Minn	min
Minutt	minut
mippche	mipɕə
mippchen	mipɕən
mir	miɐ̯
Misär	mizɛːʁ
miwléiere	mivlɜɪ̯əʁə
miwléieren	miflɜɪ̯əʁən
Miwwel	mivəl
Mixer	miksɐ
Mo	moː
mobiliséiere	mobilizɜɪ̯əʁə
mobiliséieren	mobilizɜɪ̯əʁən
mockeleg	mokələɕ
Modell	modæl
modern	modɛʁn
moer	moːɐ
mof	moːf
moie	mojə
moien	mojən
moies	mojəs
mokuch	moːkuχ
mol	moːl
molbier	moːlbiɐ̯
mole	moːlə
molen	moːlən
Moler	moːlɐ
molstëfter	moːlʃtəftɐ
moment	momænt
momper	mompɐ
Mond	mont
mondharmonika	monthɑʁmoːnikaː
Moniteur	monitœːʁ
Monni	moniː
Monsieur	məsjøː
Monster	monstɐ
montéiere	mɑ̃ːtɜɪ̯əʁə
montéieren	mɑ̃ːtɜɪ̯əʁən
monter	montɐ
monterkeet	montɐkeːt
Moolzecht	moːlt͡səɕt
Moos	moːs
Mooss	moːs
moosse	moːsə
moossen	moːsən
mopp	mop
Mord	mɔʁt
Moschter	moʃtɐ
moschtert	moʃtɐt
Moss	mos
motivéiere	motivɜɪ̯ɐə
motivéieren	motivɜɪ̯ɐən
Motor	motoːʁ
motorboot	motoːʁboːt
Motorrad	motoːʁʁaːt
motze	mot͡sə
motzen	mot͡sən
Moud	məʊ̯t
Mouk	məʊ̯k
Mound	məʊ̯nt
Mount	məʊ̯nt
moustique	mustik
muckse	muksə
mucksen	muksən
Mudder	mudɐ
mudderschrauf	mudɐʃʁɑʊ̯f
mued	muə̯t
muedebëtzeg	muə̯dəbət͡səɕ
muele	muə̯lə
muelen	muə̯lən
muer	muːɐ
Muerch	muɐɕ
Muere	muə̯ʁə
mueren	muə̯ʁən
mueres	muə̯ʁəs
Muert	muɐt
mull	mul
mullebutz	muləbut͡s
mumps	mumps
munch	munɕ
munnech	munəɕ
Mupp	mup
Muschel	muʃəl
musée	myːzeː
Musek	muzek
Museker	muzekɐ
Muskel	muskəl
musse	musə
mussen	musən
Muster	mustɐ
Mutt	mut
muttwëlleg	mutvələɕ
muttwëlles	mutvələs
Mutz	mut͡s
naache	naːχə
naachen	naːχən
naass	naːs
nach	nɑχ
nächst	nɛːkst
nächste	nækstə
nächsten	nækstən
Nahrung	naːʁuŋ
Näid	næːɪ̯t
näipe	næːɪ̯pə
näipen	næːɪ̯pən
näischnotz	næːɪ̯ʃnot͡s
näischnotzeg	næːɪ̯ʃnot͡səɕ
näischt	næːɪ̯ʃt
naiv	naːiːf
Namensdag	naːmənsdaːχ
nämlech	nɛːmləɕ
nappe	nɑp
narb	nɑʁp
narbe	nɑʁbə
narben	nɑʁbən
naschele	nɑʃələ
nascheleg	nɑʃələɕ
naschelen	nɑʃələn
Nascht	nɑʃt
Nashorn	naːshɔʁn
natierlech	nɑtiɐ̯ləɕ
national	nɑt͡sjoːnaːl
Nationalitéit	nɑt͡sjoːnɑlitɜɪ̯t
natur	nɑtuːʁ
naupe	næːʊ̯pə
Naupen	næːʊ̯pən
nawell	nɑvæl
nee	neː
Neel	neːl
neelche	neːlɕə
neelchen	neːlɕən
neelchesblumm	neːlɕəsblum
neelcheskapp	neːlɕəskɑp
neele	neːlə
neelen	neːlən
neen	neːn
nees	neːs
nei	nɑɪ̯
néideg	nɜɪ̯dəɕ
neidesch	nɑɪ̯dəʃ
Neiegkeet	nɑɪ̯əɕkeːt
néierens	nɜɪ̯əʁəns
Néiesch	nɜɪ̯əʃ
Neijooschdag	nɑɪ̯joːʃdaːχ
neimoudesch	nɑɪ̯məʊ̯dəʃ
néitsche	nɜɪ̯t͡ʃə
néitschen	nɜɪ̯t͡ʃən
néize	nɜɪ̯t͡sə
néizen	nɜɪ̯t͡sən
nëmme	nəmə
nëmmen	nəmən
néng	neŋ
néngte	neŋtə
néngten	neŋtən
Nerv	nɛʁf
Nerve	nɛʁvə
nerven	nɛʁvən
nervös	nɛʁvøːs
Nëssert	nəsɐt
net	nət
netz	næt͡s
netze	næt͡sə
netzen	næt͡sən
nëtzlech	nət͡sləɕ
netzt	næt͡st
Neveu	nəvøː
ni	niː
niddereg	nidəʁəɕ
Nidderlag	nidɐlaːχ
nidderleeën	nidɐleːən
nidderschloe	nidɐʃloːə
nidderschloen	nidɐʃloːən
nidderträchteg	nidɐtʁæɕtəɕ
nieft	niə̯ft
Nier	niɐ̯
Niere	niːʁə
nieren	niːʁən
Nies	niə̯s
niewebäi	niə̯vəbæːɪ̯
niewent	niə̯vənt
Nilpäerd	niːlpɛːɐt
nimools	niːmoːls
Niwwel	nivəl
niwweleg	nivələɕ
no	noː
nobäi	noːbæːɪ̯
nobel	noːbəl
Nodeel	noːdeːl
nodenke	noːdæŋkə
nodenken	noːdæŋkən
nogi	noːɡi
noginn	noːɡin
nogoe	noːɡoːə
nogoen	noːɡoːən
nohuele	noːhuə̯lə
nohuelen	noːhuə̯lən
nokucke	noːkukə
nokucken	noːkukən
Nol	noːl
nolauschtere	noːlæːʊ̯ʃtəʁə
nolauschteren	noːlæːʊ̯ʃtəʁən
Nolauschterer	noːlæːʊ̯ʃtəʁɐ
nole	noːlə
noléisseg	noːlɜɪ̯səɕ
Nolen	noːlən
noliese	noːliə̯zə
noliesen	noːliə̯zən
nom	noːm
Nomëtteg	noːmətəɕ
nomëttes	noːmətəs
nondikass	nondikɑs
nonzeg	nont͡səɕ
nonzéng	nont͡seŋ
Noper	noːpɐ
Noperschaft	noːpɐʃɑft
Nopesch	noːpəʃ
Norde	nɔʁdə
Norden	nɔʁdən
normal	nɔʁmaːl
Noss	nos
Notär	notɛːʁ
notéiere	notɜɪ̯əʁə
notéieren	notɜɪ̯əʁən
Notiz	notit͡s
Notizbuch	notit͡sbuχ
notze	not͡sə
notzen	not͡sən
Nout	nəʊ̯t
noutdéngscht	nəʊ̯tdeŋʃt
noutwenneg	nəʊ̯tvænəɕ
Noutwennegkeet	nəʊ̯tvænəɕkeːt
nouvelle	nuvæl
November	novæmbɐ
nu	nuː
Nuddel	nudəl
Nuebel	nuə̯bəl
Nuecht	nuə̯ɕt
nuechtegailche	nuə̯ɕtəɡɑɪ̯lɕə
nuechtegailchen	nuə̯ɕtəɡɑɪ̯lɕən
nuechtelaang	nuə̯ɕtəlaːŋ
nuechtiesse	nuə̯ʑdiə̯sə
nuechtiessen	nuə̯ʑdiə̯sən
Nues	nuə̯s
nueslach	nuə̯slɑχ
nuets	nuə̯t͡s
Nuetsdësch	nuə̯t͡sdəʃ
Nuetshiem	nuə̯t͡shiə̯m
nuetspäiperlek	nuə̯t͡spæːɪ̯pɐlek
null	nul
Numero	numəʁoː
Numm	num
Nummer	numɐ
ob	op
obwuel	opvuə̯l
Occasioun	okɑzjəʊ̯n
och	oχ
Ochs	oks
oder	oːdɐ
ofbotze	oːfbot͡sə
ofbotzen	oːfbot͡sən
ofbrenne	oːfbʁænə
ofbrennen	oːfbʁænən
ofdanke	oːfdɑŋkə
ofdanken	oːfdɑŋkən
ofdichte	oːfdiɕtə
ofdichten	oːfdiɕtən
ofdréchne	oːfdʁəɕnə
ofdréchnen	oːfdʁəɕnən
ofdreiwe	oːfdʁɑɪ̯və
ofdreiwen	oːfdʁɑɪ̯vən
Offall	oːffɑl
offréiere	ofʁɜɪ̯əʁə
offréieren	ofʁɜɪ̯əʁən
ofgerënnt	oːfɡəʁənt
ofgi	oːfɡi
ofginn	oːfɡin
ofgoe	oːfɡoːə
ofgoen	oːfɡoːən
ofgotzele	oːfɡot͡sələ
ofgotzelen	oːfɡot͡sələn
ofhake	oːfhaːkə
ofhaken	oːfhaːkən
ofhale	oːfhaːlə
ofhalen	oːfhaːlən
ofhängeg	oːfhæŋəɕ
Ofhängegkeet	oːfhæŋəɕkeːt
ofhänke	oːfhæŋkə
ofhänken	oːfhæŋkən
ofhuele	oːfhuə̯lə
ofhuelen	oːfhuə̯lən
ofkierze	oːfkiɐ̯t͡sə
ofkierzen	oːfkiɐ̯t͡sən
Ofkierzung	oːfkiɐ̯t͡suŋ
ofkille	oːfkilə
ofkillen	oːfkilən
oflafe	oːflaːfə
oflafen	oːflaːfən
ofléis	oːflɜɪ̯s
ofléise	oːflɜɪ̯zə
ofléisen	oːflɜɪ̯zən
ofluede	oːfluə̯də
oflueden	oːfluə̯dən
Ofrappe	oːfʁɑpə
ofrappen	oːfʁɑpən
ofraume	oːfʁɑʊ̯mə
ofraumen	oːfʁɑʊ̯mən
ofrënne	oːfʁənə
ofrënnen	oːfʁənən
ofschafe	oːfʃaːfə
ofschafen	oːfʃaːfən
ofschlécke	oːfʃlekə
ofschlécken	oːfʃlekən
ofschleefe	oːfʃleːfə
ofschleefen	oːfʃleːfən
ofschreiwe	oːfʃʁɑɪ̯və
ofschreiwen	oːfʃʁɑɪ̯vən
ofschwäche	oːfʃwæɕə
ofschwächen	oːfʃwæɕən
Ofso	oːfzoː
ofsoe	oːfzoːə
ofsoen	oːfzoːən
ofspäre	oːfʃpɛːʁə
ofspären	oːfʃpɛːʁən
Ofstand	oːfʃtɑnt
Ofstänn	oːfʃtæn
ofstreide	oːfʃtʁɑɪ̯də
ofstreiden	oːfʃtʁɑɪ̯dən
oft	oft
ofwiessele	oːfviə̯sələ
ofwiesselen	oːfviə̯sələn
Oktober	oktoːbɐ
oliv	oliːf
om	om
Omelett	oməlæt
onbedéngt	onbədeŋt
onbestänneg	onbəʃtænəɕ
onbestëmmt	onbəʃtəmt
ondankbar	ondɑŋkbaːʁ
ondenkbar	ondæŋkbaːʁ
onéierlech	onɜɪ̯ɐləɕ
onendlech	onændləɕ
onerhéiert	onɐhɜɪ̯ɐt
onerwaart	onɐvaːʁt
onfrëndlech	onfʁəndləɕ
ongär	onɡɛːʁ
ongedëlleg	onɡədələɕ
Ongedold	onɡədolt
ongeféier	onɡəfɜɪ̯ɐ
ongemiddelt	onɡəmidəlt
ongenéiert	onʒənɜɪ̯ɐt
ongeschécklech	onɡəʃekləɕ
ongesond	onɡəzont
ongewinnt	onɡəvint
ongezillt	onɡət͡silt
ongeziwwer	onɡət͡sivɐ
ongezwonge	onɡət͡swoŋə
ongezwongen	onɡət͡swoŋən
ongläich	onɡlæːɪ̯ɕ
Ongléck	onɡlek
onglécklech	onɡlekləɕ
onglécklecherweis	onɡlekləɕɐvɑɪ̯s
onheemlech	onheːmləɕ
onkammoud	onkɑməʊ̯t
Onkraut	onkʁæːʊ̯t
onmanéierlech	onmɑnɜɪ̯ɐləɕ
Onmass	onmɑs
onméiglech	onmɜɪ̯ʑləɕ
onnëtz	onət͡s
onofhängeg	onoːfhæŋəɕ
Onofhängegkeet	onoːfhæŋəɕkeːt
onrecht	onʁæɕt
Onrou	onʁəʊ̯
onroueg	onʁəʊ̯əɕ
ons	ons
onschiedlech	onʃiedləɕ
Onschold	onʃolt
onsécher	onsəɕɐ
ontrei	ontʁɑɪ̯
onuerdnung	onuɐdnuŋ
onvergiesslech	onfɐɡiə̯sləɕ
onverhofft	onfɐhoft
onverschimt	onfɐʃimt
onverschimtheet	onfɐʃimtheːt
onvirsichteg	onfiɐ̯ziɕtəɕ
onvirsichtegkeet	onfiɐ̯ziɕtəɕkeːt
onzefridde	ont͡səfʁidə
onzefridden	ont͡səfʁidən
ootme	oːtmə
ootmen	oːtmən
ootmung	oːtmuŋ
op	op
opbesserung	opbæsɐuŋ
opblose	opbloːzə
opblosen	opbloːzən
Opdrag	opdʁaːχ
opdränge	opdʁæŋə
opdrängen	opdʁæŋən
opdréie	opdʁɜɪ̯ə
opdréien	opdʁɜɪ̯ən
Openthalt	obənthɑlt
Oper	oːpɐ
operéiere	opəʁɜɪ̯əʁə
operéieren	opəʁɜɪ̯əʁən
operett	oːpəʁæt
opfale	op͡faːlə
opfalen	op͡faːlən
opfänke	op͡fæŋkə
opfänken	op͡fæŋkən
opfriesse	op͡fʁiə̯sə
opfriessen	op͡fʁiə̯sən
opgedonnert	opɡədonɐt
opgepasst	opɡəpɑst
Opgi	opɡi
opginn	opɡin
opgoe	opɡoːə
opgoen	opɡoːən
ophale	ophaːlə
ophalen	ophaːlən
ophänke	ophæŋkə
ophänken	ophæŋkən
ophiewe	ophiə̯və
ophiewen	ophiə̯vən
opkéipe	opkɜɪ̯pə
opkéipen	opkɜɪ̯pən
opluede	opluə̯də
oplueden	opluə̯dən
opmierksam	opmiɐ̯ksaːm
Opmierksamkeet	opmiɐ̯ksaːmkeːt
oppasse	oppɑsə
oppassen	oppɑsən
oppassert	oppɑsɐt
oprafe	opʁaːfə
oprafen	opʁaːfən
opraume	opʁɑʊ̯mə
opraumen	opʁɑʊ̯mən
opreege	opʁeːʑə
opreegen	opʁeːʑən
Opreegung	opʁeːʑuŋ
oprichteg	opʁiːɕtəɕ
opriichte	opʁiːɕtə
opriichten	opʁiːɕtən
oprulle	opʁulə
oprullen	opʁulən
opschreiwe	opʃʁɑɪ̯və
opschreiwen	opʃʁɑɪ̯vən
opschuppe	opʃupə
opschuppen	opʃupən
Opsiicht	opziːɕt
opsoe	opzoːə
opsoen	opzoːən
opsprange	opʃpʁɑŋə
opsprangen	opʃpʁɑŋən
opstoe	opʃtoːə
opstoen	opʃtoːən
opsuckele	opzukələ
opsuckelen	opzukələn
Optiker	optikɐ
opweise	opvɑɪ̯zə
opweisen	opvɑɪ̯zən
opwierme	opwiɐ̯mə
opwiermen	opwiɐ̯mən
opwuesse	opwuə̯sə
opwuessen	opwuə̯sən
opziele	opt͡siə̯lə
opzielen	opt͡siə̯lən
orange	oʁɑ̃ːʃ
orangejus	oʁɑ̃ːʃəʒyː
Organisatioun	ɔʁɡaːnizaːt͡sjəʊ̯n
organiséiere	ɔʁɡaːnizɜɪ̯əʁə
organiséieren	ɔʁɡaːnizɜɪ̯əʁən
Orthographie	ɔʁtoɡʁɑfiː
Oste	ostə
Osten	ostən
Otem	oːtəm
Otempaus	oːtəmpɑʊ̯s
Ouer	əʊ̯ɐ
ouerenentzündung	əʊ̯əʁənæntt͡synduŋ
ouerläppche	əʊ̯ɐlæpɕə
ouerläppchen	əʊ̯ɐlæpɕən
Ouerréng	əʊ̯ɐʁeŋ
ouerschlëffer	əʊ̯ɐʃləfɐ
ouni	əʊ̯niː
Ouschtere	əʊ̯ʃtəʁə
Ouschteren	əʊ̯ʃtəʁən
Ouschterhues	əʊ̯ʃtɐhuə̯s
Oval	ovaːl
owend	oːvənt
owendiesse	oːvəndiə̯sə
Owendiessen	oːvəndiə̯sən
ower	oːvɐ
owes	oːvəs
owescours	oːvəskuːɐ
oweskleed	oːvəskleːt
Paangech	paːŋəɕ
Paart	paːʁt
Pabeier	pɑbɑɪ̯ɐ
Pabeierkuerf	pɑbɑɪ̯ɐkuə̯f
packe	pɑkə
packen	pɑkən
pad	paːt
paddel	pɑdəl
paddelboot	pɑdəlboːt
paddele	pɑdələ
paddelen	pɑdələn
Päerd	pɛːɐt
Päerdercher	pɛːɐdɐɕɐ
Päerdsbier	pɛːɐt͡sbiɐ̯
päerdsstall	pɛːɐt͡sʃtɑl
paff	pɑf
Pai	pɑɪ̯
Päif	pæːɪ̯f
päife	pæːɪ̯fə
päifen	pæːɪ̯fən
paillette	pɑɪ̯æt
päinetsch	pæːɪ̯næt͡ʃ
Päiperlek	pæːɪ̯pɐlek
Päischte	pæːɪ̯ʃtə
Päischten	pæːɪ̯ʃtən
Pak	paːk
pake	paːkə
paken	paːkən
palais	pɑlɛː
palier	pɑlieː
Paltong	pɑltoŋ
pampelmuss	pɑmpəlmus
Pan	paːn
pand	pɑnt
Panda	pɑndaː
panech	paːnəɕ
panewippche	paːnəvipɕə
panewippchen	paːnəvipɕən
Pann	pɑn
Panz	pɑnt͡s
Papagei	pɑpɑɡɑɪ̯
papeg	paːpəɕ
Papp	pɑp
Paräis	pɑʁæːɪ̯s
parat	pɑʁaːt
paravent	pɑʁɑvɑ̃ː
parcours	pɑʁkuːɐ
pardon	pɑʁdɑ̃ː
Parechoc	paːʁʃok
Pärel	pɛːʁəl
Parfum	pɑʁfɛ̃ː
parfümerie	pɑʁfyməʁiː
park	pɑʁk
parke	pɑʁkə
parken	pɑʁkən
Parkplaz	pɑʁkplaːt͡s
parlamentaresch	pɑʁlaːmæntaːʁəʃ
parréck	pɑʁek
partie	pɑʁtiː
partner	pɑʁtnɐ
party	paːʁtiː
Parzeläin	pɑʁt͡səlæːɪ̯n
Parzell	pɑʁt͡sæl
Paschtouer	pɑʃtəʊ̯ɐ
pass	pɑs
Passagéier	pɑsɑʒɜɪ̯ɐ
passe	pɑsə
passen	pɑsən
Passepartout	pɑspɑʁtuː
passette	pɑsæt
passfoto	pɑsfotoː
Pater	paːtɐ
Patient	pɑt͡sjænt
patisserie	pɑtisəʁiː
patissier	pɑtisjeː
patsch	pɑt͡ʃ
Patt	pɑt
Pätter	pætɐ
Paus	pɑʊ̯s
pautsch	pæːʊ̯t͡ʃ
pawee	pɑveː
Péage	peːaːʃ
Pech	pæɕ
peche	pæɕə
pecheg	pæɕəɕ
pechen	pæɕən
Pedall	pədɑl
pédicure	peːdikyːʁ
Peffer	pæfɐ
peffermanztéi	pæfɐmɑnt͡stɜɪ̯
péiterséilech	pɜɪ̯tɐzɜɪ̯ləɕ
pelikan	peːlikaːn
Pëll	pəl
pellem	pæləm
Pelz	pælt͡s
Péng	peŋ
péngeche	peŋəɕə
péngechen	peŋəɕən
péngschte	peŋʃtə
Péngschten	peŋʃtən
penibel	peːniːbəl
péniche	peːniʃ
pénktlech	peŋktləɕ
pensée	pɑ̃ːseː
pënsel	pənzəl
pensionéiert	pænsjoːnɜɪ̯ɐt
pëppel	pəpəl
perfekt	pɛʁfækt
permanente	pɛʁmɑnɑ̃ːt
permis	pɛʁmiː
perruche	pæʁyʃ
perséinlech	pɛʁzɜɪ̯nləɕ
personal	pɛʁzonaːl
Persoun	pɛʁzəʊ̯n
Pescht	pæʃt
pëspere	pəspəʁə
pësperen	pəspəʁən
pëtrolstanker	pətʁolstɑŋkɐ
Pëtz	pət͡s
pëtze	pət͡sə
pëtzen	pət͡sən
Petzi	pæt͡siː
Phare	faːʁ
phonetik	foneːtik
piano	pjɑnoː
picke	pikə
pickeg	pikəɕ
picken	pikən
Picknick	piknik
piddele	pidələ
piddelen	pidələn
Piff	pif
piije	piːʒə
piijen	piːʒən
piisch	piːʃ
Pilger	pilʑɐ
pilgerplaz	pilʑɐplaːt͡s
pillem	piləm
Pilot	piloːt
Pilz	pilt͡s
Pinguin	piŋɡuiːn
pinsche	pinʃə
pinschen	pinʃən
Pinsel	pinzəl
piscine	pisin
pisse	pisə
pissen	pisən
Pist	pist
pittoresk	pitoʁæsk
Pizza	pit͡saː
placard	plɑkaːʁ
Plack	plɑk
Plackespiller	plɑkəʃpilɐ
plädéiere	plɛːdɜɪ̯əʁə
plädéieren	plɛːdɜɪ̯əʁən
Plafong	plɑfoŋ
plafonnéier	plɑfonɜɪ̯ɐ
Plage	plaːʃ
plakapp	plaːkɑp
plakäppeg	plaːkæpəɕ
Plakat	plɑkaːt
plakeg	plaːkəɕ
planéiere	plɑnɜɪ̯əʁə
planéieren	plɑnɜɪ̯əʁən
planet	plɑneːt
Plang	plɑŋ
plange	plɑŋə
plangen	plɑŋən
Planz	plɑnt͡s
Planze	plɑnt͡sə
planzen	plɑnt͡sən
Plastik	plɑstik
Plastikstut	plɑstikstuːt
Plastilin	plɑstilin
plateau	plɑtoː
plätschnaass	plæt͡ʃnaːs
platt	plɑt
plättche	plæt͡ɕə
plättchen	plæt͡ɕən
Platte	plɑtə
platten	plɑtən
platze	plɑt͡sə
platzen	plɑt͡sən
plaz	plaːt͡s
plécke	plekə
plécken	plekən
plënnere	plənəʁə
plënneren	plənəʁən
Pleséier	pləzɜɪ̯ɐ
Plo	ploː
ploe	ploːə
ploen	ploːən
plomm	plom
Plooschter	ploːʃtɐ
plott	plot
Plou	pləʊ̯
ploue	pləʊ̯ə
plouen	pləʊ̯ən
plover	ploːvɐ
Plüschdéier	plyʃdɜɪ̯ɐ
Pneu	pnøː
pohunn	poːhun
poléiere	polɜɪ̯əʁə
poléieren	polɜɪ̯əʁən
Politiker	politikɐ
Polizei	polit͡sɑɪ̯
Polizist	polit͡sist
polnesch	polnəʃ
polstere	polstəʁə
polsteren	polstəʁən
Polver	polfɐ
polykopéiere	polikopɜɪ̯əʁə
polykopéieren	polikopɜɪ̯əʁən
Pompel	pompəl
pompele	pompələ
pompelen	pompələn
Pompjee	pompʒeː
pompjeesauto	pompʒeːzɑʊ̯toː
Pond	pont
Pony	poniː
Popcorn	popkɔːʁn
Popp	pop
Poppenhaus	popənhæːʊ̯s
porrett	poʁæt
Portefeuille	pɔʁtəfœj
portemanteau	pɔʁtmɑ̃ːtoː
Portier	pɔʁtjeː
Portioun	pɔʁt͡sjəʊ̯n
Portmonni	pɔʁtmoniː
Portugal	pɔʁtuːɡɑl
portugisesch	pɔʁtuɡiːzəʃ
Posch	poʃ
post	post
Poteau	potoː
potere	poːtəʁə
poteren	poːtəʁən
Potti	potiː
poufank	pəʊ̯fɑŋk
pouke	pəʊ̯kə
pouken	pəʊ̯kən
Poul	pəʊ̯l
poulet	puleː
poulriicht	pəʊ̯lʁiːɕt
poussette	pusæt
Pouster	pəʊ̯stɐ
pouze	pəʊ̯t͡sə
pouzen	pəʊ̯t͡sən
Prabbeli	pʁɑbəliː
praffe	pʁɑfə
praffen	pʁɑfən
präis	pʁæːɪ̯s
praktesch	pʁɑktəʃ
praum	pʁɑʊ̯m
Praxis	pʁɑksis
präzis	pʁɛːt͡siːs
préiwe	pʁɜɪ̯və
préiwen	pʁɜɪ̯vən
Premiere	pʁəmjeːə
première	pʁəmjɛːʁ
Prënz	pʁənt͡s
préparatioun	pʁeːpɑʁɑtjəʊ̯n
Presentatioun	pʁezɑ̃ːntaːt͡sjəʊ̯n
presentéieren	pʁezɑ̃ːntɜɪ̯əʁən
presse	pʁæsə
Pressen	pʁæsən
pressessioun	pʁæsəsjəʊ̯n
Pressioun	pʁæsjəʊ̯n
presslofthummer	pʁæslofthumɐ
prêt	pʁɛː
prett	pʁæt
priedege	pʁiə̯dəʑə
priedegen	pʁiə̯dəʑən
Primärschoul	pʁimɛːʁʃəʊ̯l
Prinzessin	pʁint͡sæsin
Prisong	pʁizoŋ
Prisonnéier	pʁizonɜɪ̯ɐ
privat	pʁivaːt
pro	pʁoː
probéiere	pʁobɜɪ̯əʁə
probéieren	pʁobɜɪ̯əʁən
Problem	pʁobleːm
Produkt	pʁodukt
Produktioun	pʁoduksjəʊ̯n
produzéiere	pʁodut͡sɜɪ̯əʁə
produzéieren	pʁodut͡sɜɪ̯əʁən
Professer	pʁofæsɐ
Professesch	pʁofæsəʃ
profezeie	pʁofət͡sɑɪ̯ə
profezeien	pʁofət͡sɑɪ̯ən
profit	pʁofit
profitéiere	pʁofitɜɪ̯əʁə
profitéieren	pʁofitɜɪ̯əʁən
Programm	pʁoɡʁɑm
programméiere	pʁoɡʁɑmɜɪ̯əʁə
programméieren	pʁoɡʁɑmɜɪ̯əʁən
projet	pʁoʒeː
Projeten	pʁoʒeːən
projets	pʁoʒeː
proklaméiere	pʁoklɑmɜɪ̯əʁə
proklaméieren	pʁoklɑmɜɪ̯əʁən
prominent	pʁominænt
promm	pʁom
pronom	pʁonɑ̃ː
pronome	pʁonɑ̃ːə
pronomen	pʁonɑ̃ːən
Propeller	pʁopælɐ
proposéiere	pʁopoːzɜɪ̯əʁə
proposéieren	pʁopoːzɜɪ̯əʁən
propper	pʁopɐ
Propretéit	pʁopʁətɜɪ̯t
Prospekt	pʁospækt
Prost	pʁost
proste	pʁostə
prosten	pʁostən
Protein	pʁoteːiːn
Prouwe	pʁəʊ̯və
prouwen	pʁəʊ̯vən
Prozent	pʁot͡sænt
Pruecht	pʁuə̯ɕt
Prüfung	pʁyːfuŋ
Psalm	psaːlm
psychanalys	psikɑnaːliːs
psychesch	psiːɕəʃ
psychescher	psiɕəʃɐ
Psychiater	psikjaːtɐ
psychiatresch	psikjaːtʁəʃ
psychoanalys	psikoːɑnaːliːs
psychoanalyse	psikoːɑnaːliːzə
Psychologie	psikoːloːʒiː
psychos	psikoːs
Publicitéit	pyblisitɜɪ̯t
publizéiere	pyblit͡sɜɪ̯əʁə
publizéieren	pyblit͡sɜɪ̯əʁən
puche	puχə
puchen	puχən
Pudder	pudɐ
puddere	pudəʁə
pudderen	pudəʁən
puer	puɐ
Puff	puf
puffe	pufə
puffen	pufən
puffere	pufəʁə
pufferen	pufəʁən
Pujel	puʒəl
Pull	pul
Pullover	puloːvɐ
pünäs	pynɛːs
punkt	puŋkt
pupeg	puːpəɕ
Puppelche	pupəlɕə
Puppelchen	pupəlɕən
puppsat	pupzaːt
purée	pyːʁeː
Putsch	put͡ʃ
Pyjama	piʒɑmaː
quai	kɛː
quake	kwaːkə
quaken	kwaːkən
quäle	kwɛːlə
quälen	kwɛːlən
Qualitéit	kɑlitɜɪ̯t
Quantitéit	kɑntitɜɪ̯t
quartier	kɑʁtjeː
quatsch	kwɑt͡ʃ
queesch	kweːʃ
Quell	kwæl
Quetsch	kwæt͡ʃ
quetschekraut	kwæt͡ʃəkʁæːʊ̯t
queue	køː
quiitsche	kwiːt͡ʃə
quiitschen	kwiːt͡ʃən
Quittung	kwituŋ
raache	ʁaːχə
raachen	ʁaːχən
raaspel	ʁaːspəl
raaspele	ʁaːspələ
raaspelen	ʁaːspələn
Rabatt	ʁɑbɑt
rabbele	ʁɑbələ
rabbelen	ʁɑbələn
räbbi	ʁæbiː
Rabbiner	ʁɑbinɐ
rach	ʁɑχ
räche	ʁɛːɕə
rächen	ʁɛːɕən
Rack	ʁɑk
Rad	ʁaːt
radau	ʁɑdɑʊ̯
raddereg	ʁɑdəʁəɕ
radio	ʁaːdjoː
rafe	ʁaːfə
rafen	ʁaːfən
raffinéiert	ʁɑfinɜɪ̯ɐt
Rahm	ʁaːm
Raiber	ʁɑɪ̯bɐ
räich	ʁæːɪ̯ɕ
Räichtum	ʁæːɪ̯ɕtum
räif	ʁæːɪ̯f
Räis	ʁæːɪ̯s
Rakéit	ʁɑkɜɪ̯t
rambli	ʁɑmbliː
Rang	ʁɑŋ
Rank	ʁɑŋk
Rapp	ʁɑp
rappe	ʁɑpə
rappecht	ʁɑpəɕt
rappen	ʁɑpən
rapport	ʁɑpɔːʁ
räpse	ʁæpsə
räpsen	ʁæpsən
raquette	ʁɑkæt
rar	ʁaːʁ
rascht	ʁɑʃt
raschte	ʁɑʃtə
raschteg	ʁɑʃtəɕ
raschten	ʁɑʃtən
Rass	ʁɑs
Rat	ʁaːt
Rätsel	ʁɛːt͡səl
rau	ʁæːʊ̯
Raum	ʁæːʊ̯m
Raume	ʁɑʊ̯mə
raumen	ʁɑʊ̯mən
Raumschëff	ʁæːʊ̯mʃəf
Raup	ʁæːʊ̯p
raut	ʁæːʊ̯t
razeg	ʁaːt͡səɕ
Reaktioun	ʁeɑksjəʊ̯n
réaliséiere	ʁeɑlizɜɪ̯əʁə
réaliséieren	ʁeɑlizɜɪ̯əʁən
rebbi	ʁæbiː
réceptionniste	ʁeːsæpsjoːnist
Receptioun	ʁeːsæpsjəʊ̯n
Rechemaschinn	ʁæɕəmɑʃin
recherche	ʁəʃɛʁʃ
rechne	ʁæɕnə
rechnen	ʁæɕnən
Rechnung	ʁæɕnuŋ
recht	ʁæɕt
rechteck	ʁæʑdæk
rechts	ʁæɕt͡s
Réck	ʁek
réckele	ʁekələ
réckelen	ʁekələn
Ree	ʁeː
Reebou	ʁeːbəʊ̯
Reech	ʁeːɕ
reeche	ʁeːɕə
reechen	ʁeːɕən
Reedel	ʁeːdəl
Reef	ʁeːf
reell	ʁeːæl
reemantel	ʁeːmɑntəl
reen	ʁeːn
reene	ʁeːnə
reeneg	ʁeːnəɕ
reenen	ʁeːnən
Rees	ʁeːs
reese	ʁeːzə
reesen	ʁeːzən
Reewaasser	ʁeːwaːsɐ
reewuerm	ʁeːvuɐm
refuséiere	ʁəfyːzɜɪ̯əʁə
refuséieren	ʁəfyːzɜɪ̯əʁən
regard	ʁəɡaːʁ
Regel	ʁeːʑəl
regelméisseg	ʁeːʑəlmɜɪ̯səɕ
Regierung	ʁeːʑiːʁuŋ
régime	ʁeːʒim
réglage	ʁeːɡlaːʃ
Rei	ʁɑɪ̯
réi	ʁɜɪ̯
reide	ʁɑɪ̯də
reiden	ʁɑɪ̯dən
réiere	ʁɜɪ̯əʁə
réieren	ʁɜɪ̯əʁən
Reim	ʁɑɪ̯m
reiser	ʁɑɪ̯zɐ
reiwe	ʁɑɪ̯və
reiwen	ʁɑɪ̯vən
Reklam	ʁəklɑm
Reklamatioun	ʁəklɑmɑsjəʊ̯n
reklaméiere	ʁəklɑmɜɪ̯əʁə
reklaméieren	ʁəklɑmɜɪ̯əʁən
rekolt	ʁəkolt
Remarque	ʁəmɑʁk
remboursement	ʁɑ̃ːmbuʁsmænt
remorque	ʁəmɔʁk
Rendezvous	ʁɑ̃ːdeːvuː
Rëndfleesch	ʁəntfleːʃ
reng	ʁæŋ
rénk	ʁeŋk
renke	ʁæŋkə
renken	ʁæŋkən
renndéier	ʁændɜɪ̯ɐ
renne	ʁænə
rënne	ʁənə
rennen	ʁænən
rënnen	ʁənən
renseignement	ʁɑ̃ːsæɲəmænt
Rent	ʁænt
rentabel	ʁæntaːbəl
Reparatur	ʁəpɑʁɑtuːʁ
Reporter	ʁəpɔʁtɐ
rëpp	ʁəp
rescht	ʁæʃt
rëschte	ʁəʃtə
rëschten	ʁəʃtən
rësel	ʁəzəl
rësele	ʁəzələ
rëselen	ʁəzələn
Reserve	ʁezɛʁf
reservéiere	ʁezɛʁvɜɪ̯əʁə
reservéieren	ʁezɛʁvɜɪ̯əʁən
respekt	ʁæspækt
respektiv	ʁæspæktiːf
responsabel	ʁæspɑ̃ːsaːbəl
responsabele	ʁæspɑ̃ːsaːbələ
responsabelen	ʁæspɑ̃ːsaːbələn
Rëss	ʁəs
Ressort	ʁəsɔːʁ
restaurant	ʁæstoʁɑ̃ː
Resultat	ʁəzultaːt
retour	ʁətuːʁ
rette	ʁætə
retten	ʁætən
Rettung	ʁætuŋ
Réunioun	ʁeːynjəʊ̯n
Revolver	ʁəvolvɐ
revue	ʁəvyː
rezdechaussée	ʁeːt͡ʃoːseː
Rezept	ʁət͡sæpt
Rhytmus	ʁitmus
ribb	ʁip
ribbe	ʁibə
ribben	ʁibən
riche	ʁiɕə
richen	ʁiɕən
richteg	ʁiɕtəɕ
Rido	ʁidoː
ried	ʁiə̯t
riede	ʁiə̯də
riedele	ʁiə̯dələ
riedelen	ʁiə̯dələn
rieden	ʁiə̯dən
Riedner	ʁiə̯dnɐ
rief	ʁiə̯f
riets	ʁiə̯t͡s
riicht	ʁiːɕt
riichtaus	ʁiːʑdæːʊ̯s
riichter	ʁiːɕtɐ
riichteraus	ʁiːʑdəʁæːʊ̯s
riichtewech	ʁiːʑdəvæɕ
rill	ʁil
Rimm	ʁim
Ris	ʁiːs
riseg	ʁiːzəɕ
risele	ʁizələ
riselen	ʁizələn
Riserad	ʁiːzəʁaːt
riskéiere	ʁiskɜɪ̯əʁə
riskéieren	ʁiskɜɪ̯əʁən
Roboter	ʁobotɐ
rode	ʁoːdə
roden	ʁoːdən
roff	ʁof
roll	ʁol
rollschong	ʁolʃoŋ
Rollstull	ʁolʃtul
rollued	ʁolluə̯t
rolze	ʁolt͡sə
rolzen	ʁolt͡sən
roman	ʁomaːn
romantesch	ʁomɑntəʃ
romarin	ʁomɑʁɛ̃ː
Rommel	ʁoməl
Rondel	ʁondəl
ronderëm	ʁondəʁəm
ronke	ʁoŋkə
ronken	ʁoŋkən
ronn	ʁon
ronschel	ʁonʃəl
ronschele	ʁonʃələ
ronschelen	ʁonʃələn
rosa	ʁoːzaː
rose	ʁoːzə
rosen	ʁoːzən
Roserei	ʁozəʁɑɪ̯
rot	ʁoːt
rou	ʁəʊ̯
roudelzeg	ʁəʊ̯dəlt͡səɕ
roue	ʁəʊ̯ə
roueg	ʁəʊ̯əɕ
rouen	ʁəʊ̯ən
Rouer	ʁəʊ̯ɐ
roulad	ʁulaːt
roulade	ʁulaːdə
rouladen	ʁulaːdən
Roulotte	ʁulot
Rous	ʁəʊ̯s
Rouscht	ʁəʊ̯ʃt
Rouse	ʁəʊ̯zə
Rousekranz	ʁəʊ̯zəkʁɑnt͡s
Rousen	ʁəʊ̯zən
rout	ʁəʊ̯t
Routine	ʁutin
Rucksak	ʁukzaːk
Rücksicht	ʁykziɕt
Rudder	ʁudɐ
rudderboot	ʁudɐboːt
ruddere	ʁudəʁə
rudderen	ʁudəʁən
ruffe	ʁufə
ruffen	ʁufən
Rugby	ʁyɡbiː
Ruin	ʁuːiːn
rull	ʁul
rulle	ʁulə
rullen	ʁulən
rumänesch	ʁumɛːnəʃ
Rumm	ʁum
Rüssel	ʁysəl
russesch	ʁusəʃ
rutschbahn	ʁut͡ʃbaːn
rutsche	ʁut͡ʃə
rutschen	ʁut͡ʃən
Rutt	ʁut
Saach	zaːχ
Saaft	zaːft
sabbelduch	zɑbəlduχ
sabbele	zɑbələ
sabbelen	zɑbələn
sächlech	zæɕləɕ
sachlech	zɑχləɕ
säfteg	zæftəɕ
Saier	zɑɪ̯ɐ
säin	zæːɪ̯n
saison	sɛːzɑ̃ː
säit	zæːɪ̯t
Sak	zaːk
Sakgaass	zaːkɡaːs
salef	zaːləf
Sall	zɑl
sällche	zælɕə
sällchen	zælɕən
salon	sɑlɑ̃ː
Salz	zɑlt͡s
salzdëppche	zɑlt͡sdəpɕə
salzdëppchen	zɑlt͡sdəpɕən
salze	zɑlt͡sə
salzeg	zɑlt͡səɕ
salzen	zɑlt͡sən
Sam	zaːm
Samett	zaːmæt
sammele	zɑmələ
sammelen	zɑmələn
Samschdeg	zɑmʃdəɕ
samschdes	zɑmʃdəs
Sand	zɑnt
sandal	zɑndaːl
sandauer	zɑndɑʊ̯ɐ
sandbuerg	zɑntbuɐɕ
sandkëscht	zɑntkəʃt
sandwich	sæntwit͡ʃ
sange	zɑŋə
sangen	zɑŋən
Sänger	zæŋɐ
Sängerin	zæŋəʁin
sat	zaːt
Sau	zæːʊ̯
sauer	zɑʊ̯ɐ
sauerampel	zɑʊ̯ɐɑmpəl
Sauerkraut	zɑʊ̯ɐkʁɑʊ̯t
Sauermous	zɑʊ̯ɐməʊ̯s
Sauerstoff	zɑʊ̯ɐʃtof
saufe	zæːʊ̯fə
saufen	zæːʊ̯fən
Sauna	zɑʊ̯naː
Saz	zaːt͡s
schaardeg	ʃaːʁdəɕ
schaarf	ʃaːʁf
schaaschtech	ʃaːʃtəɕ
Schach	ʃɑχ
Schäerft	ʃɛːɐft
Schaf	ʃaːf
schafe	ʃaːfə
schafen	ʃaːfən
Schäffche	ʃæfɕə
Schäffchen	ʃæfɕən
Schaffdag	ʃɑfdaːχ
Schäffe	ʃæfə
schaffe	ʃɑfə
Schäffen	ʃæfən
schaffen	ʃɑfən
Schaffert	ʃɑfɐt
schaime	ʃɑɪ̯mə
schaimen	ʃɑɪ̯mən
Schäin	ʃæːɪ̯n
schäissdreck	ʃæːɪ̯sdʁæk
schäisse	ʃæːɪ̯sə
schäissen	ʃæːɪ̯sən
Schal	ʃaːl
schale	ʃaːlə
Schalen	ʃaːlən
schallekseg	ʃɑleksəɕ
Schalter	ʃɑltɐ
Schampes	ʃɑmpəs
Schan	ʃaːn
Schank	ʃɑŋk
Schapp	ʃɑp
schappe	ʃɑpə
schappeg	ʃɑpəɕ
schappen	ʃɑpən
Schatz	ʃɑt͡s
schätze	ʃæt͡sə
schätzen	ʃæt͡sən
Schätzung	ʃæt͡suŋ
Schauer	ʃɑʊ̯ɐ
schauere	ʃɑʊ̯əʁə
schaueren	ʃɑʊ̯əʁən
schaukel	ʃɑʊ̯kəl
schaukele	ʃɑʊ̯kələ
schaukelen	ʃɑʊ̯kələn
Schaukelpäerd	ʃɑʊ̯kəlpɛːɐt
Schaum	ʃæːʊ̯m
schaumläffel	ʃæːʊ̯mlæfəl
Schauspiller	ʃɑʊ̯ʃpilɐ
Schauspillerin	ʃɑʊ̯ʃpiləʁin
schausseg	ʃæːʊ̯səɕ
Scheck	ʃæk
scheckbuch	ʃækbuχ
schécke	ʃekə
schécken	ʃekən
schëdde	ʃədə
schëdden	ʃədən
scheede	ʃeːdə
scheeden	ʃeːdən
Scheedung	ʃeːduŋ
Schëff	ʃəf
schei	ʃɑɪ̯
Scheier	ʃɑɪ̯ɐ
Schéier	ʃɜɪ̯ɐ
schéifer	ʃɜɪ̯fɐ
schéin	ʃɜɪ̯n
Schéinheet	ʃɜɪ̯nheːt
Scheinwerfer	ʃɑɪ̯nvɛʁfɐ
schéissbud	ʃɜɪ̯sbuːt
schéisse	ʃɜɪ̯sə
schéissen	ʃɜɪ̯sən
Schëld	ʃəlt
Schell	ʃæl
schelle	ʃælə
schellen	ʃælən
Schëller	ʃəlɐ
schénge	ʃeŋə
schéngen	ʃeŋən
schenke	ʃæŋkə
schenken	ʃæŋkən
Schëpp	ʃəp
schëppche	ʃəpɕə
schëppchen	ʃəpɕən
Schi	ʃiː
schibengel	ʃiːbæŋəl
schick	ʃik
Schicksal	ʃikzaːl
schiedlech	ʃiə̯dləɕ
schiele	ʃiə̯lə
schielen	ʃiə̯lən
schierbel	ʃiɐ̯bəl
Schierbele	ʃiɐ̯bələ
Schierbelen	ʃiɐ̯bələn
Schiertech	ʃiɐ̯təɕ
Schiet	ʃiə̯t
schif	ʃiːf
schifer	ʃiːfɐ
Schildkröt	ʃiltkʁøːt
schimmeg	ʃiməɕ
schimmeleg	ʃimələɕ
schimt	ʃimt
Schinn	ʃin
schippelche	ʃipəlɕə
schippelchen	ʃipəlɕən
Schlaang	ʃlaːŋ
Schlagsahn	ʃlaːχsaːn
schläiche	ʃlæːɪ̯ɕə
schläichen	ʃlæːɪ̯ɕən
schläife	ʃlæːɪ̯fə
schläifen	ʃlæːɪ̯fən
schlaksert	ʃlɑksɐt
schlamm	ʃlɑm
schlank	ʃlɑŋk
schlapp	ʃlɑp
Schlass	ʃlɑs
Schlässer	ʃlæsɐ
schlau	ʃlɑʊ̯
Schlauch	ʃlæːʊ̯χ
schlecht	ʃlæɕt
Schléck	ʃlek
schlécke	ʃlekə
schlécken	ʃlekən
schleefe	ʃleːfə
schleefen	ʃleːfən
Schleek	ʃleːk
schleekenhaische	ʃleːkənhɑɪ̯sjə
Schleekenhaischen	ʃleːkənhɑɪ̯sjən
schleidere	ʃlɑɪ̯dəʁə
schleideren	ʃlɑɪ̯dəʁən
Schleier	ʃlɑɪ̯ɐ
schléif	ʃlɜɪ̯f
schléifer	ʃlɜɪ̯fɐ
schleis	ʃlɑɪ̯s
schléiwe	ʃlɜɪ̯və
schléiwen	ʃlɜɪ̯vən
schléiwenheck	ʃlɜɪ̯vənhæk
schlëmm	ʃləm
Schlëssel	ʃləsəl
Schlësselbee	ʃləsəlbeː
Schlësselbeen	ʃləsəlbeːn
schlëssellach	ʃləsəllɑχ
schliisslech	ʃliːsləɕ
schlips	ʃlips
Schlitt	ʃlit
Schlittschong	ʃlit͡ʃoŋ
Schlitz	ʃlit͡s
schloe	ʃloːə
schloen	ʃloːən
Schlof	ʃloːf
schlofe	ʃloːfə
schlofen	ʃloːfən
Schloff	ʃlof
schlofkap	ʃloːfkaːp
Schlofkummer	ʃloːfkumɐ
Schlofsak	ʃloːfzaːk
Schlofzëmmer	ʃloːft͡səmɐ
schloper	ʃloːpɐ
schloree	ʃloʁeː
schloreen	ʃloʁeːn
schluecht	ʃluə̯ɕt
schluechte	ʃluə̯ɕtə
schluechten	ʃluə̯ɕtən
Schluechthaus	ʃluə̯ɕthæːʊ̯s
Schluet	ʃluə̯t
Schlupp	ʃlup
schluppe	ʃlupə
schluppen	ʃlupən
Schluss	ʃlus
schmaache	ʃmaːχə
schmaachen	ʃmaːχən
Schmalz	ʃmɑlt͡s
schmeier	ʃmɑɪ̯ɐ
schmëlze	ʃməlt͡sə
schmëlzen	ʃməlt͡sən
Schmier	ʃmiɐ̯
Schmiere	ʃmiə̯ʁə
schmieren	ʃmiə̯ʁən
schmotzeg	ʃmot͡səɕ
schmuddeleg	ʃmudələɕ
schmuel	ʃmuə̯l
schmuelef	ʃmuə̯ləf
schmull	ʃmul
schmunze	ʃmunt͡sə
schmunzen	ʃmunt͡sən
schnaarche	ʃnaːʁɕə
schnaarchen	ʃnaːʁɕən
schnäize	ʃnæːɪ̯t͡sə
schnäizen	ʃnæːɪ̯t͡sən
schnape	ʃnaːpə
schnapen	ʃnaːpən
Schnapp	ʃnɑp
Schnaps	ʃnɑps
Schnatt	ʃnɑt
Schnauer	ʃnɑʊ̯ɐ
Schnauz	ʃnæːʊ̯t͡s
schneekeg	ʃneːkəɕ
Schnéi	ʃnɜɪ̯
schnéibiesem	ʃnɜɪ̯biə̯zəm
schneide	ʃnɑɪ̯də
schneiden	ʃnɑɪ̯dən
Schneider	ʃnɑɪ̯dɐ
schneie	ʃnɑɪ̯ə
schneien	ʃnɑɪ̯ən
Schnéiflack	ʃnɜɪ̯flɑk
Schnéiklatz	ʃnɜɪ̯klɑt͡s
schnéimännche	ʃnɜɪ̯mænɕə
Schnéimännchen	ʃnɜɪ̯mænɕən
schnéiwick	ʃnɜɪ̯vik
schnell	ʃnæl
schnëppel	ʃnəpəl
Schnëss	ʃnəʃ
schnësse	ʃnəsə
schnëssen	ʃnəsən
schnëtze	ʃnət͡sə
schnëtzen	ʃnət͡sən
Schniewel	ʃniə̯vəl
Schnitzel	ʃnit͡səl
schnoffele	ʃnofələ
schnoffelen	ʃnofələn
Schnouer	ʃnəʊ̯ɐ
schnuddel	ʃnudəl
Schnuddelhong	ʃnudəlhoŋ
Schnurres	ʃnuʁəs
scho	ʃo
Schock	ʃok
Schockela	ʃokəlaː
Schof	ʃoːf
schokant	ʃokɑnt
schold	ʃolt
Schong	ʃoŋ
schonggréisst	ʃoŋɡʁɜɪ̯st
schongläffel	ʃoŋlæfəl
schongnummer	ʃoŋnumɐ
schongstréckel	ʃoŋʃtʁekəl
schonn	ʃon
Schossel	ʃosəl
schoul	ʃəʊ̯l
Schoulmeeschter	ʃəʊ̯lmeːʃtɐ
Schoulsak	ʃəʊ̯lzaːk
schoune	ʃəʊ̯nə
schounen	ʃəʊ̯nən
schouschter	ʃəʊ̯ʃtɐ
Schräiner	ʃʁæːɪ̯nɐ
Schratt	ʃʁɑt
Schrauf	ʃʁɑʊ̯f
schraufstack	ʃʁɑʊ̯fʃtɑk
Schrauwe	ʃʁɑʊ̯və
schrauwemudder	ʃʁɑʊ̯vəmudɐ
schrauwen	ʃʁɑʊ̯vən
schrauwenzéier	ʃʁɑʊ̯vənt͡sɜɪ̯ɐ
Schreck	ʃʁæk
schrécke	ʃʁekə
schrécken	ʃʁekən
schrecklech	ʃʁækləɕ
Schrëft	ʃʁəft
schrëftlech	ʃʁəftləɕ
Schrëftsteller	ʃʁəft͡ʃtælɐ
Schreifdësch	ʃʁɑɪ̯fdəʃ
Schreifmaschinn	ʃʁɑɪ̯fmɑʃin
schréips	ʃʁɜɪ̯ps
Schréipse	ʃʁɜɪ̯psə
Schréipsen	ʃʁɜɪ̯psən
schreiwe	ʃʁɑɪ̯və
schreiwen	ʃʁɑɪ̯vən
schro	ʃʁoː
Schrott	ʃʁot
schrubbe	ʃʁubə
schrubben	ʃʁubən
schrubber	ʃʁubɐ
schrumm	ʃʁum
schubkar	ʃubkaːʁ
Schudder	ʃudɐ
schuddere	ʃudəʁə
schudderen	ʃudəʁən
Schueberfouer	ʃuə̯bɐfəʊ̯ɐ
schued	ʃuə̯t
schuede	ʃuə̯də
schueden	ʃuə̯dən
Schuel	ʃuə̯l
Schüler	ʃyːlɐ
Schülerin	ʃyːləʁin
schumme	ʃumə
schummen	ʃumən
schupp	ʃup
schutzblech	ʃut͡sblæɕ
schütze	ʃyt͡sə
schützen	ʃyt͡sən
schwaach	ʃwaːχ
schwaachheet	ʃwaːχheːt
schwaarz	ʃwaːʁt͡s
schwäche	ʃwæɕə
schwächen	ʃwæɕən
schwächt	ʃwæɕt
schwäerme	ʃwɛːɐmə
schwäermen	ʃwɛːɐmən
Schwäin	ʃwæːɪ̯n
schwäistall	ʃwæːɪ̯ʃtɑl
Schwäiz	ʃwæːɪ̯t͡s
Schwammbox	ʃwɑmboks
schwamme	ʃwɑmə
schwammen	ʃwɑmən
Schwamp	ʃwɑmp
Schwan	ʃwaːn
Schwanz	ʃwɑnt͡s
schwätze	ʃwæt͡sə
schwätzen	ʃwæt͡sən
schwedesch	ʃweːdəʃ
Schweess	ʃweːs
schweesse	ʃweːsə
schweessen	ʃweːsən
schwéier	ʃwɜɪ̯ɐ
schwéiereltere	ʃwɜɪ̯ɐæltəʁə
schwéierelteren	ʃwɜɪ̯ɐæltəʁən
schwéierleit	ʃwɜɪ̯ɐlɑɪ̯t
Schwéiermamm	ʃwɜɪ̯ɐmɑm
Schwéierpapp	ʃwɜɪ̯ɐpɑp
Schwéiesch	ʃwɜɪ̯əʃ
schwëlle	ʃwələ
schwëllen	ʃwələn
Schwemm	ʃwæm
Schwëmmer	ʃwəmɐ
Schwéngefleesch	ʃweŋəfleːʃ
Schwéngerei	ʃweŋəʁɑɪ̯
schwéngskotlett	ʃweŋskotlæt
schwenke	ʃwæŋkə
schwenken	ʃwæŋkən
Schwëster	ʃwəstɐ
Schwier	ʃwiɐ̯
schwiere	ʃwiə̯ʁə
schwiereg	ʃwiːʁəɕ
Schwieregkeet	ʃwiːʁəɕkeːt
schwieren	ʃwiə̯ʁən
schwiewe	ʃwiə̯və
schwiewen	ʃwiə̯vən
Schwoer	ʃwoːɐ
Schwonk	ʃwoŋk
Scout	skɑʊ̯t
se	zə
sech	zəɕ
séchel	zəɕəl
sécher	zəɕɐ
Sécherheet	zəɕɐheːt
sécherheetsglas	zəɕɐheːt͡sɡlaːs
sécherheetsnetz	zəɕɐheːt͡snæt͡s
Sécherheetsrimm	zəɕɐheːt͡sʁim
sechs	zæks
sechste	zækstə
sechsten	zækstən
sechzeg	zæɕt͡səɕ
séckche	zekɕə
séckchen	zekɕən
see	zeː
Seeche	zeːɕə
Seechen	zeːɕən
Seechomes	zeːʑoːməs
seeën	zeːən
Seef	zeːf
seefe	zeːfə
seefen	zeːfən
seefepolver	zeːfəpolfɐ
Seel	zeːl
Seeldänzer	zeːldænt͡sɐ
seele	zeːlə
seelen	zeːlən
seelsprange	zeːlʃpʁɑŋə
seelsprangen	zeːlʃpʁɑŋən
seemiel	zeːmiə̯l
seen	zeːn
seene	zeːnə
seenen	zeːnən
sëff	zəf
sëffer	zəfɐ
segel	zeːʑəl
Segelboot	zeːʑəlboːt
segele	zeːʑələ
Segelen	zeːʑələn
seguer	zəɡuɐ
Séi	zɜɪ̯
seibecke	zɑɪ̯bækə
seibecken	zɑɪ̯bækən
seid	zɑɪ̯t
séie	zɜɪ̯ə
séien	zɜɪ̯ən
séier	zɜɪ̯ɐ
Séihond	zɜɪ̯hont
séikrank	zɜɪ̯kʁɑŋk
Séil	zɜɪ̯l
séiss	zɜɪ̯s
séiwaasser	zɜɪ̯vaːsɐ
Sekonn	zəkon
Sekretär	səkʁetɛːʁ
Sekretariat	səkʁetɑʁjaːt
Sekretärin	səkʁetɛːʁin
sëllech	zələɕ
selwer	zælvɐ
sëlwer	zəlvɐ
sëndege	zəndəʑə
sëndegen	zəndəʑən
seng	zeŋ
sënn	zən
September	zæptembɐ
Serie	seʁiː
seriö	sæʁjøː
Serveuse	sɛʁvøːs
service	sɛʁvis
Servicer	sɛʁvisɐ
sëtz	zət͡s
setze	zæt͡sə
sëtze	zət͡sə
setzen	zæt͡sən
sëtzen	zət͡sən
Sëtzung	zət͡suŋ
seufze	zoɪft͡sə
seufzen	zoɪft͡sən
short	ʃɔʁt
si	zi
si	ziː
siche	ziɕə
sichen	ziɕən
sickere	zikəʁə
sickeren	zikəʁən
siechzeg	ziə̯ɕt͡səɕ
siechzéng	ziə̯ɕt͡seŋ
sief	ziə̯f
siff	zif
siffe	zifə
siffen	zifən
sinistréiert	sinistʁɜɪ̯ɐt
sinn	zin
Sireen	siʁeːn
sirup	siʁup
siwe	ziːvə
siwen	ziːvən
siwente	ziːvəntə
siwenten	ziːvəntən
siweschléifer	ziːvəʃlɜɪ̯fɐ
siwwenzeg	zivənt͡səɕ
siwwenzéng	zivənt͡seŋ
Skizz	skit͡s
soe	zoːə
soen	zoːən
solde	soldə
Solden	soldən
solle	zolə
sollen	zolən
Som	zoːm
Sonn	zon
Sonndeg	zondəɕ
sonndes	zondəs
sonneg	zonəɕ
sonneprabbeli	zonəpʁɑbəliː
sonnestéch	zonəʃtəɕ
soss	zos
sou	zəʊ̯
soubal	zəʊ̯baːl
sougenannt	zəʊ̯ɡənɑnt
souguer	zəʊ̯ɡuɐ
soutien	sutjɛ̃ː
souvill	zəʊ̯fil
souwisou	zəʊ̯vizəʊ̯
Spaass	ʃpaːs
spaasse	ʃpaːsə
spaasseg	ʃpaːsəɕ
spaassen	ʃpaːsən
spachtel	ʃpɑχtəl
spackelter	ʃpɑkəltɐ
spadséiere	ʃpɑdzɜɪ̯əʁə
spadséieren	ʃpɑdzɜɪ̯əʁən
Spadséiergank	ʃpɑdzɜɪ̯ɐɡɑŋk
Spaghetti	ʃpɑɡætiː
Späicher	ʃpæːɪ̯ɕɐ
späize	ʃpæːɪ̯t͡sə
späizen	ʃpæːɪ̯t͡sən
spane	ʃpaːnə
spanen	ʃpaːnən
Spann	ʃpɑn
Spanne	ʃpɑnə
spannen	ʃpɑnən
spannend	ʃpɑnənt
Spannung	ʃpɑnuŋ
späre	ʃpɛːʁə
spären	ʃpɛːʁən
Spargel	ʃpɑʁʑəl
spatz	ʃpɑt͡s
Spaut	ʃpæːʊ̯t
Spaweck	ʃpaːvæk
Specht	ʃpæɕt
Speck	ʃpæk
Speis	ʃpɑɪ̯s
spéit	ʃpɜɪ̯t
spéitstens	ʃpɜɪ̯t͡stəns
Spektiv	ʃpæktiːf
Spéngel	ʃpeŋəl
spéngele	ʃpeŋələ
spéngelen	ʃpeŋələn
spënnche	ʃpənɕə
Spënnchen	ʃpənɕən
Spëtzbouf	ʃpət͡sbəʊ̯f
Spëtze	ʃpət͡sə
spëtzen	ʃpət͡sən
Spëtznumm	ʃpət͡snum
spëtzt	ʃpət͡st
Spezialist	ʃpeːt͡sjɑlist
spezifesch	ʃpet͡siːfəʃ
Spidol	ʃpidoːl
spiecht	ʃpiə̯ɕt
spiere	ʃpiːʁə
spieren	ʃpiːʁən
Spigel	ʃpiʑəl
spigelee	ʃpiʑəleː
spill	ʃpil
spillbuttek	ʃpilbutek
spille	ʃpilə
spillen	ʃpilən
Spillplaz	ʃpilplaːt͡s
Spillsaach	ʃpilzaːχ
Spinat	ʃpinaːt
Spioun	ʃpjəʊ̯n
spläiter	ʃplæːɪ̯tɐ
spléck	ʃplek
splécke	ʃplekə
splécken	ʃplekən
splitter	ʃplitɐ
sport	ʃpɔʁt
sportlech	ʃpɔʁtləɕ
spottnumm	ʃpotnum
sprangbur	ʃpʁɑŋbuːʁ
sprange	ʃpʁɑŋə
sprangen	ʃpʁɑŋən
sprangseel	ʃpʁɑŋzeːl
sprechzëmmer	ʃpʁæɕt͡səmɐ
spréif	ʃpʁɜɪ̯f
sprenz	ʃpʁænt͡s
Sprëtz	ʃpʁət͡s
Sprëtze	ʃpʁət͡sə
sprëtzen	ʃpʁət͡sən
sprinkler	ʃpʁiŋklɐ
sprock	ʃpʁok
Spronk	ʃpʁoŋk
sprooch	ʃpʁoːχ
spruddele	ʃpʁudələ
spruddeleg	ʃpʁudələɕ
spruddelen	ʃpʁudələn
Spruddelwaasser	ʃpʁudəlvaːsɐ
sprutze	ʃpʁut͡sə
sprutzen	ʃpʁut͡sən
spuenesch	ʃpuə̯nəʃ
Spuenie	ʃpuə̯niə̯
Spuenien	ʃpuə̯niə̯n
Spuerbéchs	ʃpuɐbeks
spuere	ʃpuə̯ʁə
spueren	ʃpuə̯ʁən
Spuerkeess	ʃpuɐkeːs
spuervull	ʃpuɐful
spuet	ʃpuə̯t
spull	ʃpul
spulle	ʃpulə
spullen	ʃpulən
Spullmaschinn	ʃpulmɑʃin
spullomp	ʃpullomp
spullstee	ʃpulʃtee
spullsteen	ʃpulʃteen
Spur	ʃpuːʁ
Sputt	ʃput
Staang	ʃtaːŋ
staark	ʃtaːʁk
Staatsrot	ʃtaːt͡sʁoːt
stäbercher	ʃtɛːbɐɕɐ
stabill	ʃtɑbil
stachel	ʃtɑχəl
Stack	ʃtɑk
stackfësch	ʃtɑkfəʃ
Stad	ʃtaːt
stage	staːʃ
stäil	ʃtæːɪ̯l
Stäip	ʃtæːɪ̯p
stäipe	ʃtæːɪ̯pə
stäipen	ʃtæːɪ̯pən
stall	ʃtɑl
stallhale	ʃtɑlhaːlə
stallhalen	ʃtɑlhaːlən
Stamm	ʃtɑm
Standard	stɑ̃ːndaːʁ
Stär	ʃtɛːʁ
starte	ʃtaːʁtə
starten	ʃtaːʁtən
Starter	ʃtaːʁtɐ
Stat	ʃtaːt
Statu	ʃtaːtuː
Stau	ʃtɑʊ̯
Staubsauger	ʃtæːʊ̯bzɑʊ̯ɡɐ
Staumauer	ʃtɑʊ̯mɑʊ̯ɐ
staune	ʃtɑʊ̯nə
staunen	ʃtɑʊ̯nən
Stauséi	ʃtɑʊ̯zɜɪ̯
staut	ʃtæːʊ̯t
Stëbs	ʃtəps
stëbse	ʃtəpsə
stëbsen	ʃtəpsən
stëbsfatz	ʃtəpsfɑt͡s
stëbslomp	ʃtəpslomp
Stéck	ʃtek
Steckdous	ʃtækdəʊ̯s
Stecker	ʃtækɐ
stéckseg	ʃteksəɕ
Stee	ʃteː
Steekaul	ʃteːkɑʊ̯l
Steemetzer	ʃteːmæt͡sɐ
Steen	ʃteːn
Steier	ʃtɑɪ̯ɐ
Stéier	ʃtɜɪ̯ɐ
stéiere	ʃtɜɪ̯əʁə
stéieren	ʃtɜɪ̯əʁən
steif	ʃtɑɪ̯f
Stéifkand	ʃtɜɪ̯fkɑnt
Stéifmamm	ʃtɜɪ̯fmɑm
Stéifpapp	ʃtɜɪ̯fpɑp
steiwe	ʃtɑɪ̯və
steiwen	ʃtɑɪ̯vən
stëll	ʃtəl
stelle	ʃtælə
stellen	ʃtælən
stelz	ʃtælt͡s
Stëmm	ʃtəm
stëmme	ʃtəmə
stëmmen	ʃtəmən
Stëmmung	ʃtəmuŋ
Stempel	ʃtæmpəl
stempele	ʃtæmpələ
Stempelen	ʃtæmpələn
stenge	ʃtæŋə
stengen	ʃtæŋən
sténke	ʃteŋkə
sténken	ʃteŋkən
stënterlech	ʃtəntɐləɕ
stëppche	ʃtəpɕə
stëppchen	ʃtəpɕən
steppe	ʃtæpə
stëppele	ʃtəpələ
stëppelen	ʃtəpələn
steppen	ʃtæpən
steriliséiere	ʃteʁilizɜɪ̯əʁə
steriliséieren	ʃteʁilizɜɪ̯əʁən
stiedche	ʃtiə̯t͡ɕə
Stiedchen	ʃtiə̯t͡ɕən
stiele	ʃtiə̯lə
stielen	ʃtiə̯lən
stierme	ʃtiɐ̯mə
stiermen	ʃtiɐ̯mən
stierwe	ʃtiɐ̯və
stierwen	ʃtiɐ̯vən
stierze	ʃtiɐ̯t͡sə
stierzen	ʃtiɐ̯t͡sən
stiichte	ʃtiːɕtə
stiichten	ʃtiːɕtən
still	ʃtil
stitzche	ʃtit͡sjə
stitzchen	ʃtit͡sjən
Stiwwel	ʃtivəl
stodéiere	ʃtodɜɪ̯əʁə
stodéieren	ʃtodɜɪ̯əʁən
stodent	ʃtodænt
stoe	ʃtoːə
stoen	ʃtoːən
Stoff	ʃtof
Stol	ʃtoːl
stolpere	ʃtolpəʁə
stolperen	ʃtolpəʁən
stomm	ʃtom
stompeg	ʃtompəɕ
Stonn	ʃton
stonnelaang	ʃtonəlaːŋ
stop	ʃtop
Stopp	ʃtop
stoppe	ʃtopə
stoppen	ʃtopən
stoppenzéier	ʃtopənt͡sɜɪ̯ɐ
stopschëld	ʃtopʃəlt
Storch	ʃtɔʁɕ
store	stɔːʁ
Stot	ʃtoːt
stousse	ʃtəʊ̯sə
stoussen	ʃtəʊ̯sən
sträiche	ʃtʁæːɪ̯ɕə
sträichen	ʃtʁæːɪ̯ɕən
Sträif	ʃtʁæːɪ̯f
Sträit	ʃtʁæːɪ̯t
stral	ʃtʁaːl
Strapp	ʃtʁɑp
Strass	ʃtʁɑs
Strauch	ʃtʁæːʊ̯χ
Strauss	ʃtʁæːʊ̯s
Stréch	ʃtʁəɕ
streckbriet	ʃtʁækbʁiə̯t
strecke	ʃtʁækə
strécke	ʃtʁekə
stréckel	ʃtʁekəl
strecken	ʃtʁækən
strécken	ʃtʁekən
stréckleeder	ʃtʁekleːdɐ
Streech	ʃtʁeːɕ
streeën	ʃtʁeən
Stréi	ʃtʁɜɪ̯
stréiballe	ʃtʁɜɪ̯bɑlə
stréiballen	ʃtʁɜɪ̯bɑlən
streide	ʃtʁɑɪ̯də
streiden	ʃtʁɑɪ̯dən
streidereg	ʃtʁɑɪ̯dəʁəɕ
stréihutt	ʃtʁɜɪ̯hut
Streik	ʃtʁɑɪ̯k
stréile	ʃtʁɜɪ̯lə
stréilen	ʃtʁɜɪ̯lən
Strëmp	ʃtʁəmp
streng	ʃtʁæŋ
Strenz	ʃtʁænt͡s
Strof	ʃtʁoːf
Strofe	ʃtʁoːfə
Strofen	ʃtʁoːfən
Strooss	ʃtʁoːs
stroossekaart	ʃtʁoːsəkaːʁt
Stroosseluucht	ʃtʁoːsəluːχt
Stroosseschëld	ʃtʁoːsəʃəlt
Stroum	ʃtʁəʊ̯m
Strummert	ʃtʁumɐt
stuckele	ʃtukələ
stuckelen	ʃtukələn
studéiere	ʃtudɜɪ̯əʁə
studéieren	ʃtudɜɪ̯əʁən
Student	ʃtudænt
stuerke	ʃtuɐkə
stuerken	ʃtuɐkən
Stuerm	ʃtuɐm
stuff	ʃtuf
Stull	ʃtul
stulldreiwend	ʃtuldʁɑɪ̯vənt
stur	ʃtuːʁ
stylo	stiloː
Suckel	zukəl
suckele	zukələ
suckelen	zukələn
Süde	zyːdə
Süden	zyːdən
Sue	zuːə
Suedel	zuə̯dəl
Suel	zuə̯l
Suen	zuə̯n
Suerg	zuɐɕ
suerge	zuɐʑə
suergen	zuɐʑən
suggeréiere	syɡʒeʁɜɪ̯əʁə
suggeréieren	syɡʒeʁɜɪ̯əʁən
sujet	syʒeː
Sujete	syʒeːə
summer	zumɐ
Summerwee	zumɐweː
super	zupɐ
Supp	zup
suppeg	zupəɕ
suppel	supəl
Surfe	sœːʁfə
surfen	sœːʁfən
surveillant	syʁvɛːjɑ̃ː
sympathesch	simpaːtəʃ
Taart	taːʁt
taaschte	taːʃtə
taaschten	taːʃtən
Tabell	tɑbæl
tableau	tɑbloː
Tablette	tɑblæt
tabouret	tɑbuʁeː
tachtele	tɑχtələ
tachtelen	tɑχtələn
Tafel	taːfəl
taille	tɑɪ̯l
talent	tɑlənt
tallek	tɑlek
Tank	tɑŋk
tanke	tɑŋkə
tanken	tɑŋkən
tankwon	tɑŋkvoːn
Tapéit	tɑpɜɪ̯t
tarnung	tɑʁnuŋ
tas	taːs
Täsch	tæʃ
Täscheluucht	tæʃəluːχt
Täschemesser	tæʃəmæsɐ
tässele	tæsələ
tässelen	tæsələn
tatsächlech	taːtzæɕləɕ
Tatta	tɑtaː
tatz	tɑt͡s
taucher	tæːʊ̯χɐ
tausche	tæːʊ̯ʃə
tauschen	tæːʊ̯ʃən
Taxi	tɑksiː
Techniker	tæɕnikɐ
técke	tekə
técken	tekən
Teenager	tiːnɜɪ̯d͡ʒɐ
Téi	tɜɪ̯
Téitsch	tɜɪ̯t͡ʃ
Tëlee	təleː
Telefon	tələfon
telefonéiere	tələfonɜɪ̯əʁə
telefonéieren	tələfonɜɪ̯əʁən
Telefonsbuch	tələfonsbuχ
Telefonsnummer	tələfonsnumɐ
telegramm	tələɡʁɑm
teleskop	telæskoːp
Televisioun	tələvizjəʊ̯n
Teller	tælɐ
tellerche	tælɐɕə
tellerchen	tælɐɕən
tëmpche	təmpɕə
Tëmpchen	təmpɕən
Temperatur	tæmpəʁɑtuːʁ
Tendenz	tændænt͡s
Tennis	tænis
Tënt	tənt
Teppech	tæpəɕ
termäin	tɛʁmæːɪ̯n
terrain	tæʁɛ̃ː
Terrass	tæʁɑs
tëschent	təʃənt
tëschewand	təʃəvɑnt
text	tækst
Theater	teaːtɐ
Thermometer	tɛʁmomeːtɐ
Thon	tɑ̃ː
Thüringer	tyʁiŋɐ
ticket	tikeː
ticketsautomat	tikeːzɑʊ̯tomaːt
tierkele	tiɐ̯kələ
tierkelen	tiɐ̯kələn
Tiger	tiːɡɐ
Timber	tɛ̃ːmbɐ
Tipp	tip
Tippe	tipə
tippen	tipən
tiptop	tiptop
Tirang	tiʁɑŋ
tirebouchon	tiɐ̯buʃɑ̃ː
Titel	titəl
toast	toʊst
Toaster	toʊstɐ
tobe	toːbə
toben	toːbən
Toilette	twɑlæt
Toilettepabeier	twɑlætəpɑbɑɪ̯ɐ
toleréiere	toləʁɜɪ̯əʁə
toleréieren	toləʁɜɪ̯əʁən
tomat	tomaːt
tomatejus	tomaːtəjyː
Tommel	toməl
tommele	tomələ
tommelen	tomələn
tompe	tompə
tompen	tompən
topeg	toːpəɕ
Topert	toːpɐt
torschong	tɔʁʃoŋ
Tosch	toʃ
Toun	təʊ̯n
tour	tuːʁ
Tourist	tuʁist
tous	tus
Toz	toːt͡s
toze	toːt͡sə
tozen	toːt͡sən
traditionell	tʁɑditjonæl
Training	tʁɛːniŋ
Träip	tʁæːɪ̯p
träipe	tʁæːɪ̯pə
Träipen	tʁæːɪ̯pən
Trakter	tʁɑktɐ
Tram	tʁɑm
trampele	tʁɑmpələ
trampelen	tʁɑmpələn
träntele	tʁæntələ
träntelen	tʁæntələn
Trap	tʁaːp
trapez	tʁɑpeːt͡s
Trapp	tʁɑp
Tratt	tʁɑt
traue	tʁɑʊ̯ə
trauen	tʁɑʊ̯ən
Trauer	tʁɑʊ̯ɐ
trauerweid	tʁɑʊ̯ɐvɑɪ̯t
traufel	tʁæːʊ̯fəl
traureg	tʁɑʊ̯ʁəɕ
Trausch	tʁæːʊ̯ʃ
treffe	tʁæfə
treffen	tʁæfən
trei	tʁɑɪ̯
treiheet	tʁɑɪ̯heːt
Tréin	tʁɜɪ̯n
tréischte	tʁɜɪ̯ʃtə
tréischten	tʁɜɪ̯ʃtən
trëlle	tʁələ
trëllen	tʁələn
Trëndel	tʁəndəl
trenne	tʁænə
trennen	tʁænən
Trennung	tʁænuŋ
trëppele	tʁəpələ
trëppelen	tʁəpələn
trepplek	tʁæplek
trëttbriet	tʁətbʁiə̯t
trëtz	tʁət͡s
trëtze	tʁət͡sə
trëtzen	tʁət͡sən
Trick	tʁik
triichter	tʁiːɕtɐ
tripsen	tʁipsən
triwwele	tʁivələ
triwwelen	tʁivələn
tromm	tʁom
Trommelfell	tʁoməlfæl
Trompett	tʁompæt
troter	tʁoːtɐ
Trottinette	tʁotinæt
trottoir	tʁotwaːʁ
Trottoiren	tʁotwaːʁən
trotz	tʁot͡s
trotzdem	tʁot͡sdeːm
trotze	tʁot͡sə
trotzeg	tʁot͡səɕ
trotzen	tʁot͡sən
Troun	tʁəʊ̯n
Trouscht	tʁəʊ̯ʃt
Truh	tʁuː
Trupp	tʁup
Tsunami	t͡sunaːmiː
Tubak	tubaːk
tuddele	tudələ
tuddelen	tudələn
Tuerm	tuɐm
Tulp	tulp
tunnel	tunæl
tuppi	tupiː
turbot	tyʁboː
turne	tuʁnə
Turnen	tuʁnən
turner	tuʁnɐ
turnschlapp	tuʁnʃlɑp
tuschbic	tuʃbik
tut	tuːt
Tute	tuːtə
tuten	tuːtən
Typ	tip
ubanne	ubɑnə
ubannen	ubɑnən
übe	yːbə
üben	yːbən
ubezuele	ubət͡suə̯lə
ubezuelen	ubət͡suə̯lən
ubidde	ubidə
ubidden	ubidən
ubiede	ubiə̯də
ubieden	ubiə̯dən
uboot	uːboːt
Übung	yːbuŋ
Uebst	uə̯bst
uebstpress	uə̯bstpʁæs
uechter	uə̯ɕtɐ
uechzeg	uə̯ɕt͡səɕ
uechzéng	uə̯ɕt͡seŋ
Uelech	uə̯ləɕ
uerdentlech	uɐdəntləɕ
Uerdnung	uɐdnuŋ
uerg	uɐɕ
Uerteel	uɐteːl
Uertschaft	uɐt͡ʃɑft
uess	uə̯s
ueter	uə̯tɐ
uewe	uə̯və
uewen	uə̯vən
uewenop	uə̯vənop
Ufänger	ufæŋɐ
Ufank	ufɑŋk
ufänke	ufæŋkə
ufänken	ufæŋkən
Ufer	uːfɐ
ufuere	ufuə̯ʁə
ufueren	ufuə̯ʁən
ugeklote	uɡəkloːtə
Ugekloten	uɡəkloːtən
ugesi	uɡəzi
ugesinn	uɡəzin
ugi	uɡi
uginn	uɡin
uglotze	uɡlot͡sə
uglotzen	uɡlot͡sən
ugoe	uɡoːə
ugoen	uɡoːən
ugräife	uɡʁæːɪ̯fə
ugräifen	uɡʁæːɪ̯fən
Ugrëff	uɡʁəf
ugrëffeg	uɡʁəfəɕ
ugrëffer	uɡʁəfɐ
ukënnege	ukənəʑə
ukënnegen	ukənəʑən
Uklo	ukloː
ukloe	ukloːə
ukloen	ukloːən
ukomme	ukomə
ukommen	ukomən
ukräize	ukʁæːɪ̯t͡sə
ukräizen	ukʁæːɪ̯t͡sən
ulackele	ulɑkələ
ulackelen	ulɑkələn
uleeën	uleːən
Ulm	ulm
um	um
Umeldung	umælduŋ
umelle	umælə
umellen	umælən
umoosse	umoːsə
umoossen	umoːsən
undoe	undoːə
undoen	undoːən
undrécke	undʁekə
undrécken	undʁekən
unerkenne	unɐkænə
unerkennen	unɐkænən
unhale	unhaːlə
unhalen	unhaːlən
Unhaltspunkt	unhɑlt͡spuŋkt
Unhänger	unhæŋɐ
unhänglech	unhæŋləɕ
unhänglechkeet	unhæŋləɕkeːt
unhänke	unhæŋkə
unhänken	unhæŋkən
unhu	unhu
unhuele	unhuə̯lə
unhuelen	unhuə̯lən
unhunn	unhun
uniform	unifɔʁm
upake	upaːkə
upaken	upaːkən
upasse	upɑsə
upassen	upɑsən
Upassung	upɑsuŋ
uplanze	uplɑnt͡sə
uplanzen	uplɑnt͡sən
ureege	uʁeːʑə
ureegen	uʁeːʑən
uriede	uʁiə̯də
urieden	uʁiə̯dən
urmënsch	uːʁmənʃ
Ursaach	uːʁzaːχ
ursprénglech	uːʁʃpʁeŋləɕ
uruffe	uʁufə
uruffen	uʁufən
Uschäin	uʃæːɪ̯n
uschäisse	uʃæːɪ̯sə
uschäissen	uʃæːɪ̯sən
uschmiere	uʃmiɐ̯ə
uschmieren	uʃmiɐ̯ən
usoe	uzoːə
usoen	uzoːən
ustieche	uʃtiə̯ɕə
ustiechen	uʃtiə̯ɕən
ustiechend	uʃtiə̯ɕənt
ustiwwele	uʃtivələ
ustiwwelen	uʃtivələn
Ustrach	uʃtʁɑχ
usträiche	uʃtʁæːɪ̯ɕə
usträichen	uʃtʁæːɪ̯ɕən
Usträicher	uʃtʁæːɪ̯ɕɐ
ustrécke	uʃtʁekə
ustrécken	uʃtʁekən
Ustrengung	uʃtʁæŋuŋ
uvertraue	ufɐtʁɑʊ̯ə
uvertrauen	ufɐtʁɑʊ̯ən
uweise	uvɑɪ̯zə
uweisen	uvɑɪ̯zən
uweisung	uvɑɪ̯zuŋ
uze	uːt͡sə
uzen	uːt͡sən
vag	vaːk
Vakanz	vɑkɑnt͡s
Vas	vaːs
vasen	vaːzən
vee	veː
veen	veːn
Véi	fɜɪ̯
véier	fɜɪ̯ɐ
véiereck	fɜɪ̯ɐæk
véiereckeg	fɜɪ̯ɐækəɕ
véierel	fɜɪ̯əʁəl
véierelsstonn	fɜɪ̯əʁəlsʃton
véierte	fɜɪ̯ɐtə
véierten	fɜɪ̯ɐtən
véierzeg	fɜɪ̯ɐt͡səɕ
véierzéng	fɜɪ̯ɐt͡seŋ
vëlleche	fələɕə
vëllechen	fələɕən
vëlleg	fələɕ
Vëlo	vəloː
vëlosartist	vəloːzɑʁtist
Vëlosfuerer	vəloːsfuə̯ʁɐ
vëlossport	vəloːsʃpɔʁt
Vendeur	vɑ̃ːndœːʁ
Vendeuse	vɑ̃ːndøːs
ventouse	vɑ̃ːtuːs
Veräin	fəʁæːɪ̯n
verännere	fɐænəʁə
veränneren	fɐænəʁən
Verännerung	fɐænəʁuŋ
veräschtelung	fɐæʃtəluŋ
Verb	vɛʁp
Verband	fɐbɑnt
verbanne	fɐbɑnə
verbannen	fɐbɑnən
verbattert	fɐbɑtɐt
verbéie	fɐbɜɪ̯ə
verbéien	fɐbɜɪ̯ən
verbessere	fɐbæsəʁə
verbesseren	fɐbæsəʁən
verbëtze	fɐbət͡sə
verbëtzen	fɐbət͡sən
verbidde	fɐbidə
verbidden	fɐbidən
Verbindung	fɐbinduŋ
verblatze	fɐblɑt͡sə
verblatzen	fɐblɑt͡sən
verbléie	fɐblɜɪ̯ə
verbléien	fɐblɜɪ̯ən
verblenne	fɐblænə
verblennen	fɐblænən
verblöde	fɐbløːdə
verblöden	fɐbløːdən
verbrauch	fɐbʁæːʊ̯χ
verbrauche	fɐbʁæːʊ̯χə
verbrauchen	fɐbʁæːʊ̯χən
Verbraucher	fɐbʁæːʊ̯χɐ
verbraucht	fɐbʁæːʊ̯χt
verbreede	fɐbʁeːdə
verbreeden	fɐbʁeːdən
verbrénge	fɐbʁeŋə
verbréngen	fɐbʁeŋən
verbrenne	fɐbʁænə
verbrennen	fɐbʁænən
Verbrieche	fɐbʁiə̯ɕə
Verbriechen	fɐbʁiə̯ɕən
Verbriecher	fɐbʁiə̯ɕɐ
verbuede	fɐbuə̯də
verbueden	fɐbuə̯dən
Verdacht	fɐdɑχt
verdächteg	fɐdæɕtəɕ
verdächtege	fɐdæɕtəʑə
verdächtegen	fɐdæɕtəʑən
verdaddert	fɐdɑdɐt
verdame	fɐdaːmə
verdamen	fɐdaːmən
verdaue	fɐdɑʊ̯ə
verdauen	fɐdɑʊ̯ən
verdauung	fɐdɑʊ̯uŋ
verdeedege	fɐdeːdəʑə
verdeedegen	fɐdeːdəʑən
verdeele	fɐdeːlə
verdeelen	fɐdeːlən
verdénge	fɐdeŋə
verdéngen	fɐdeŋən
Verdéngscht	fɐdeŋʃt
verdënne	fɐdənə
verdënnen	fɐdənən
verdillege	fɐdiləʑə
verdillegen	fɐdiləʑən
verdonste	fɐdonstə
verdonsten	fɐdonstən
verdreckst	fɐdʁækst
verdréie	fɐdʁɜɪ̯ə
verdréien	fɐdʁɜɪ̯ən
verdreiwe	fɐdʁɑɪ̯və
verdreiwen	fɐdʁɑɪ̯vən
verdroe	fɐdʁoːə
verdroen	fɐdʁoːən
verdross	fɐdʁos
verduebele	fɐduə̯bələ
verduebelen	fɐduə̯bələn
verdutzt	fɐdut͡st
vereelzt	fɐeːlst
vereenegt	fəʁeːnəɕt
veréiere	fəʁɜɪ̯əʁə
veréieren	fəʁɜɪ̯əʁən
vereinfache	fəʁɑɪ̯nfɑχə
vereinfachen	fəʁɑɪ̯nfɑχən
verfaule	fɐfɑʊ̯lə
verfaulen	fɐfɑʊ̯lən
verfeele	fɐfeːlə
verfeelen	fɐfeːlən
verféiere	fɐfɜɪ̯əʁə
verféieren	fɐfɜɪ̯əʁən
verflucht	fɐfluχt
verfollege	fɐfoləʑə
verfollegen	fɐfoləʑən
verfroosse	fɐfʁoːsə
verfroossen	fɐfʁoːsən
Vergaangenheet	fɐɡaːŋənheːt
vergewaltege	fɐɡəvɑltəʑə
vergewaltegen	fɐɡəvɑltəʑən
vergiesse	fɐɡiə̯sə
vergiessen	fɐɡiə̯sən
vergläiche	fɐɡlæːɪ̯ɕə
vergläichen	fɐɡlæːɪ̯ɕən
vergréissere	fɐɡʁɜɪ̯səʁə
vergréisseren	fɐɡʁɜɪ̯səʁən
verhale	fɐhaːlə
verhalen	fɐhaːlən
Verhalt	fɐhɑlt
verhandele	fɐhɑndələ
verhandelen	fɐhɑndələn
verheemleche	fɐheːmləɕə
verheemlechen	fɐheːmləɕən
verhéiere	fɐhɜɪ̯əʁə
verhéieren	fɐhɜɪ̯əʁən
verhënnere	fɐhənəʁə
verhënneren	fɐhənəʁən
verhonze	fɐhont͡sə
verhonzen	fɐhont͡sən
verkafe	fɐkaːfə
verkafen	fɐkaːfən
Verkeefer	fɐkeːfɐ
verkeeferin	fɐkeːfəʁin
Verkéier	fɐkɜɪ̯ɐ
verkéiersluucht	fɐkɜɪ̯ɐsluːχt
verkéiert	fɐkɜɪ̯ɐt
verklappe	fɐklɑpə
verklappen	fɐklɑpən
verkleede	fɐkleːdə
verkleeden	fɐkleːdən
verkniwwelt	fɐknivəlt
verkrauche	fɐkʁæːʊ̯χə
verkrauchen	fɐkʁæːʊ̯χən
verkrëppelt	fɐkʁəpəlt
verkuebele	fɐkuə̯bələ
verkuebelen	fɐkuə̯bələn
verlaange	fɐlaːŋə
verlaangen	fɐlaːŋən
verlaangere	fɐlaːŋəʁə
Verlaangeren	fɐlaːŋəʁən
verlängere	fɐlæŋəʁə
verlängeren	fɐlæŋəʁən
verléiere	fɐlɜɪ̯əʁə
verléieren	fɐlɜɪ̯əʁən
verléift	fɐlɜɪ̯ft
verletze	fɐlæt͡sə
verletzen	fɐlæt͡sən
Verletzung	fɐlæt͡suŋ
verlobe	fɐloːbə
verloben	fɐloːbən
Verlobung	fɐloːbuŋ
verloosse	fɐloːsə
verloossen	fɐloːsən
Verloscht	fɐloʃt
verloune	fɐləʊ̯nə
verlounen	fɐləʊ̯nən
verluge	fɐluʁə
verlugen	fɐluʁən
vermaache	fɐmaːχə
vermaachen	fɐmaːχən
vermësche	fɐməʃə
vermëschen	fɐməʃən
vermuersche	fɐmuə̯ʁʃə
vermuerschen	fɐmuə̯ʁʃən
vermuuschte	fɐmuːʃtə
vermuuschten	fɐmuːʃtən
vernenne	fɐnænə
vernennen	fɐnænən
vernis	vɛʁniː
vernoléissege	fɐnoːlɜɪ̯səʑə
vernoléissegen	fɐnoːlɜɪ̯səʑən
verongléckte	fəʁonɡlektə
Verongléckten	fəʁonɡlektən
Verpackung	fɐpɑkuŋ
verpake	fɐpaːkə
verpaken	fɐpaːkən
verpasse	fɐpɑsə
verpassen	fɐpɑsən
verpolfere	fɐpolfəʁə
verpolferen	fɐpolfəʁən
verréckt	fɐʁekt
Verréider	fɐʁɜɪ̯dɐ
verrode	fəʁoːdə
verroden	fəʁoːdən
Verrot	fɐʁoːt
vers	vɛʁs
versammele	fɐzɑmələ
versammelen	fɐzɑmələn
Versammlung	fɐzɑmluŋ
versaue	fɐzɑʊ̯ə
versauen	fɐzɑʊ̯ən
verschafe	fɐʃaːfə
verschafen	fɐʃaːfən
verschampeléiere	fɐʃɑmpəlɜɪ̯əʁə
verschampeléieren	fɐʃɑmpəlɜɪ̯əʁən
verschidde	fɐʃidə
verschidden	fɐʃidən
verschimmele	fɐʃimələ
verschimmelen	fɐʃimələn
verschlass	fɐʃlɑs
verschlechtere	fɐʃlæɕtəʁə
verschlechteren	fɐʃlæɕtəʁən
verschlëmmere	fɐʃləməʁə
verschlëmmeren	fɐʃləməʁən
verschmotze	fɐʃmotzə
verschmotzen	fɐʃmotzən
verschotert	fɐʃoːtɐt
verschreiwe	fɐʃʁɑɪ̯və
verschreiwen	fɐʃʁɑɪ̯vən
verschwanne	fɐʃwɑnə
verschwannen	fɐʃwɑnən
verschweesst	fɐʃweːst
Verschwendung	fɐʃwænduŋ
verschwomme	fɐʃwomə
verschwommen	fɐʃwomən
verséchere	fɐzəɕəʁə
versécheren	fɐzəɕəʁən
Versécherung	fɐzəɕəʁuŋ
versécherungsspéngel	fɐzəɕəʁuŋsʃpeŋəl
versenge	fɐzæŋə
versengen	fɐzæŋən
versiche	fɐziɕə
versichen	fɐziɕən
Versoe	fɐzoːə
versoen	fɐzoːən
verspéide	fɐʃpɜɪ̯də
verspéiden	fɐʃpɜɪ̯dən
Verspéidung	fɐʃpɜɪ̯duŋ
versprieche	fɐʃpʁiə̯ɕə
verspriechen	fɐʃpʁiə̯ɕən
verstäerke	fɐʃtɛːɐkə
verstäerken	fɐʃtɛːɐkən
Verstäerkung	fɐʃtɛːɐkuŋ
Verstand	fɐʃtɑnt
verstänneg	fɐʃtænəɕ
Verstännegkeet	fɐʃtænəɕkeːt
verstauche	fɐʃtæːʊ̯χə
verstauchen	fɐʃtæːʊ̯χən
verstauchung	fɐʃtæːʊ̯χuŋ
verstéiert	fɐʃtɜɪ̯ɐt
verstoe	fɐʃtoːə
verstoen	fɐʃtoːən
verstoppe	fɐʃtopə
verstoppen	fɐʃtopən
verstouss	fɐʃtəʊ̯s
verstreeën	fɐʃtʁeən
versuchskanéngche	fɐzuχskɑneŋɕə
versuchskanéngchen	fɐzuχskɑneŋɕən
Versuchung	fɐzuːχuŋ
versuerge	fɐzuɐʑə
versuergen	fɐzuɐʑən
vertausche	fɐtæːʊ̯ʃə
vertauschen	fɐtæːʊ̯ʃən
vertraue	fɐtʁɑʊ̯ə
vertrauen	fɐtʁɑʊ̯ən
Vertrieder	fɐtʁiə̯dɐ
Veruechtung	fɐuə̯ɕtuŋ
veruerteele	fɐuɐteːlə
veruerteelen	fɐuɐteːlən
verwallt	fɐvɑlt
verwalte	fɐvɑltə
verwalten	fɐvɑltən
verwandele	fɐvɑndələ
verwandelen	fɐvɑndələn
verwéckele	fɐvekələ
verwéckelen	fɐvekələn
verweigere	fɐvɑɪ̯ʑəʁə
verweigeren	fɐvɑɪ̯ʑəʁən
verwieleche	fɐviə̯ləɕə
verwielechen	fɐviə̯ləɕən
verwiessele	fɐviə̯sələ
verwiesselen	fɐviə̯sələn
Verwiesslung	fɐviə̯sluŋ
verwinne	fɐvinə
verwinnen	fɐvinən
verwonnere	fɐvonəʁə
verwonneren	fɐvonəʁən
verwurrele	fɐvuʁələ
verwurrelen	fɐvuʁələn
verzeie	fɐt͡sɑɪ̯ə
verzeien	fɐt͡sɑɪ̯ən
verzichte	fɐt͡siɕtə
verzichten	fɐt͡siɕtən
verziele	fɐt͡siə̯lə
verzielen	fɐt͡siə̯lən
verziere	fɐt͡siə̯ʁə
verzieren	fɐt͡siə̯ʁən
verzolle	fɐt͡solə
verzollen	fɐt͡solən
Verzweiflung	fɐt͡swɑɪ̯fluŋ
verzweiwele	fɐt͡swɑɪ̯vələ
verzweiwelen	fɐt͡swɑɪ̯vələn
Vestiaire	væstjɛːʁ
Veterinär	vətəʁinɛːʁ
veterinären	veːtəʁinɛːʁən
veterinärin	vətəʁinɛːʁin
vexéiere	væksɜɪ̯əʁə
vexéieren	væksɜɪ̯əʁən
Vidange	vidɑ̃ːʃ
videoscassette	videːoːskɑsæt
viischt	fiːʃt
vijenzeg	fiʑənt͡səɕ
vill	fil
Villa	vilaː
Villche	filɕə
Villchen	filɕən
villsäiteg	filzæːɪ̯təɕ
vinaigrette	vinɛːɡʁæt
violett	violæt
virausgesi	fiːʁæːʊ̯sɡəzi
virausgesinn	fiːʁæːʊ̯sɡəzin
viraussoe	fiːʁæːʊ̯szoːə
viraussoen	fiːʁæːʊ̯szoːən
virbereede	fiɐ̯bəʁeːdə
virbereeden	fiɐ̯bəʁeːdən
Virbereedung	fiɐ̯bəʁeːduŋ
Virdeel	fiɐ̯deːl
virdrun	fiɐ̯dʁun
virfuere	fiɐ̯fuə̯ʁə
virfueren	fiɐ̯fuə̯ʁən
Virgäertche	fiɐ̯ɡɛːɐt͡ɕə
Virgäertchen	fiɐ̯ɡɛːɐt͡ɕən
Virgänger	fiɐ̯ɡæŋɐ
virgëschter	fiɐ̯ɡəʃtɐ
virgesi	fiɐ̯ɡəzi
virgesinn	fiɐ̯ɡəzin
virgoe	fiɐ̯ɡoːə
virgoen	fiɐ̯ɡoːən
virgräife	fiɐ̯ɡʁæːɪ̯fə
virgräifen	fiɐ̯ɡʁæːɪ̯fən
Virléift	fiɐ̯lɜɪ̯ft
Virnumm	fiɐ̯num
Virschlag	fiɐ̯ʃlaːχ
virschloe	fiɐ̯ʃloːə
virschloen	fiɐ̯ʃloːən
virsichteg	fiɐ̯ziɕtəɕ
Virsprong	fiɐ̯ʃpʁoŋ
virstelle	fiɐ̯ʃtælə
virstellen	fiɐ̯ʃtælən
Virstellung	fiɐ̯ʃtæluŋ
virufuere	fiːʁufuə̯ʁə
virufueren	fiːʁufuə̯ʁən
virugoe	fiːʁuɡoːə
virugoen	fiːʁuɡoːən
virun	fiːʁun
virundreiwe	fiːʁundʁɑɪ̯və
virundreiwen	fiːʁundʁɑɪ̯vən
virwäsch	fiɐ̯væʃ
virwerfe	fiɐ̯vɛʁfə
virwerfen	fiɐ̯vɛʁfən
virwetz	fiɐ̯vət͡s
virwetzeg	fiɐ̯vət͡səɕ
virwetztut	fiɐ̯vət͡stuːt
Virworf	fiɐ̯vɔʁf
visàvis	vizaːviː
Visitekaart	vizitəkaːʁt
vitrin	vitʁin
Viz	fiːt͡s
vläicht	flæːɪ̯ɕt
voila	vwɑlaː
Vokal	vokaːl
voll	fol
Vollek	folek
Vollekszielung	folekst͡siə̯luŋ
Vollert	folɐt
vollkommenheet	folkomənheːt
vrun	fʁun
vu	fu
vue	vyː
Vuë	vyːə
Vuen	vyːən
Vugel	fuʁəl
vulgär	vylɡɛːʁ
Vulkan	vulkaːn
vulkane	vulkaːnə
vulkanescher	vulkaːnəʃɐ
vulkanescht	vulkaːnəʃt
Vull	ful
vullekiischt	fuləkiːʃt
vullenhaische	fulənhɑɪ̯sjə
vullenhaischen	fulənhɑɪ̯sjən
vulleschäich	fuləʃæːɪ̯ɕ
vum	fum
vun	fun
wa	vɑ
waache	vaːɕə
waachen	vaːɕən
waakreg	vaːkʁəɕ
waarde	vaːʁdə
waarden	vaːʁdən
waarm	vaːʁm
waarzel	vaːʁt͡səl
Waasser	vaːsɐ
Waasserfaarwe	vaːsɐfaːʁvə
waasserfaarwen	vaːsɐfaːʁvən
Waasserfall	vaːsɐfɑl
waasserpouke	vaːsɐpəʊ̯kə
waasserpouken	vaːsɐpəʊ̯kən
waasserschi	vaːsɐʃiː
waasserstee	vaːsɐʃteː
waassersteen	vaːsɐʃteːn
Waassertuerm	vaːsɐtuɐm
wackele	vɑkələ
wackelegem	vɑkələʑəm
wackelegen	vɑkələʑən
wackeleger	vɑkələʑɐ
wackelen	vɑkələn
Wäermt	vɛːɐmt
wäertes	vɛːɐtəs
Waff	vɑf
Wagon	vɑɡɑ̃ː
wahlbureaue	vaːlbyʁoːə
wahlbureauen	vaːlbyʁoːən
wahrscheinlech	vaːʁʃɑɪ̯nləɕ
währungsuniounen	vɛːʁuŋsunjəʊ̯nən
Wäikeller	væːɪ̯kælɐ
Wäin	væːɪ̯n
wäisheetszant	væːɪ̯sheːt͡st͡sɑnt
wäiss	væːɪ̯s
wäisslech	væːɪ̯sləɕ
wäit	væːɪ̯t
wäitsichteg	væːɪ̯t͡siɕtəɕ
wak	vaːk
wakelter	vaːkəltɐ
wakeregem	vaːkəʁəʑəm
walbureaue	vaːlbyʁoːə
walbureauen	vaːlbyʁoːən
walbüroen	vaːlbyʁoːən
Wale	vaːlə
Walen	vaːlən
Walfësch	vaːlfəʃ
Walkampf	vaːlkɑmp͡f
Wallis	vɑlis
walross	vaːlʁos
Walz	vɑlt͡s
walziedele	vaːlt͡siə̯dələ
walziedelen	vaːlt͡siə̯dələn
Wand	vɑnt
wanders	vɑndɐs
wandert	vɑndɐt
wandlunge	vɑndluŋə
wandlungen	vɑndluŋən
Wandmille	vɑntmilə
Wandmillen	vɑntmilən
wandschaf	vɑnt͡ʃaːf
Wandstouss	vɑnt͡ʃtəʊ̯s
wann	vɑn
wanne	vɑnə
wannen	vɑnən
Wanter	vɑntɐ
Wanterpneu	vɑntɐpnøː
Wantersport	vɑntɐʃpɔʁt
war	vaːɐ
war	vaːʁ
waren	vaːʁən
warndräieck	vɑʁndʁæːɪ̯ek
warne	vɑʁnə
warnen	vɑʁnən
Warnung	vɑʁnuŋ
warscheinlech	vaːʁʃɑɪ̯nləɕ
Wartesall	vɑʁtəzɑl
wärungsuniounen	vɛːʁuŋsunjəʊ̯nən
Wäsch	væʃ
Wäschanlag	væʃɑnlaːχ
wäschanlage	væʃɑnlaːʁə
waschanlage	vɑʃɑnlaːʁə
Wäschbier	væʃbiɐ̯
wäsche	væʃə
wäschen	væʃən
Wäscherei	væʃɐɑɪ̯
wäschkiche	væʃkiɕə
wäschkichen	væʃkiɕən
Wäschmaschinn	væʃmɑʃin
wäschpolver	væʃpolfɐ
wasserdicht	vɑsɐdiɕt
wasserleitung	vɑsɐlɑɪ̯tuŋ
wat	vaːt
Watt	vɑt
Wecker	vækɐ
wee	veː
weeche	veːɕə
weechen	veːɕən
Weed	veːt
weekend	wiːkænt
weekendhaischen	wiːkænthɑɪ̯sjən
weekendhaisercher	wiːkænthɑɪ̯zɐɕɐ
Weenchen	veːnɕən
weenercher	weːnɐɕɐ
Weesekand	veːzəkɑnt
weess	veːs
wéi	vɜɪ̯
weibche	vɑɪ̯pɕə
Weibchen	vɑɪ̯pɕən
weiblech	vɑɪ̯bləɕ
weid	vɑɪ̯t
weide	vɑɪ̯də
wéidéings	vɜɪ̯dɜɪ̯ŋs
wéidéingt	vɜɪ̯dɜɪ̯ŋt
weiden	vɑɪ̯dən
Weiderentwécklung	vɑɪ̯dɐəntvekluŋ
weiderfuere	vɑɪ̯dɐfuə̯ʁə
weiderfueren	vɑɪ̯dɐfuə̯ʁən
weidergoe	vɑɪ̯dɐɡoːə
weidergoen	vɑɪ̯dɐɡoːən
weie	vɑɪ̯ə
wéie	vɜɪ̯ə
weien	vɑɪ̯ən
wéien	vɜɪ̯ən
Weier	vɑɪ̯ɐ
wéimere	vɜɪ̯məʁə
wéimeren	vɜɪ̯məʁən
wéineg	vɜɪ̯nəɕ
wéineger	vɜɪ̯nəʑɐ
wéini	vɜɪ̯niː
wéinst	vɜɪ̯nst
wéinstens	vɜɪ̯nstəns
weis	vɑɪ̯s
weise	vɑɪ̯zə
weisen	vɑɪ̯zən
weit	vɑɪ̯t
Wëld	vəlt
well	væl
wëll	vəl
wëlle	vələ
wëllen	vələn
Welt	vælt
Weltall	vældɑl
weltmeeschterinne	væltmeːʃtəʁinə
weltmeeschterinnen	væltmeːʃtəʁinən
weltmier	væltmiɐ̯
weltmierer	væltmiːʁɐ
Weltrekord	væltʁəkɔʁt
Weltrekorder	væltʁəkɔʁdɐ
Weltwonner	væltvonɐ
wëmper	vəmpɐ
wëndel	vəndəl
Wéngert	veŋɐt
wénke	veŋkə
Wénkel	veŋkəl
wénken	veŋkən
wenne	vænə
wennen	vænən
wënsche	vənʃə
wënschen	vənʃən
werfe	vɛʁfə
werfen	vɛʁfən
wesentlech	veːzəntləɕ
wësse	vəsə
wëssen	vəsən
Wëssenschaftler	vəsənʃɑftlɐ
wëssenschaftlerin	vəsənʃɑftləʁin
wëssenschaftlerinne	vəsənʃɑftləʁinə
wëssenschaftlerinnen	vəsənʃɑftləʁinən
Weste	væstə
Westen	væstən
Wett	væt
wette	vætə
wetten	vætən
wetzstee	væt͡sʃteː
wetzsteen	væt͡sʃteːn
wibbele	vibələ
wibbeleg	vibələɕ
wibbelegem	vibələʑəm
wibbelegen	vibələʑən
wibbelen	vibələn
wichs	viks
wichsbiischt	viksbiːʃt
wichsbiischten	viksbiːʃtən
wichse	viksə
wichsen	viksən
wichteg	viɕtəɕ
widder	vidɐ
widderhuele	vidɐhuə̯lə
widderhuelen	vidɐhuə̯lən
widderspréchs	vidɐʃpʁəɕs
widdersprécht	vidɐʃpʁəɕt
widderspriech	vidɐʃpʁiə̯ɕ
widdersprieche	vidɐʃpʁiə̯ɕə
widderspriechen	vidɐʃpʁiə̯ɕən
widderstoe	vidɐʃtoːə
widderstoen	vidɐʃtoːən
wie	viə̯
wieder	viə̯dɐ
wiedere	viə̯dəʁə
wiedereg	viə̯dəʁəɕ
wiederen	viə̯dəʁən
Wiel	viə̯l
wiele	viə̯lə
wielech	viə̯ləɕ
wielen	viə̯lən
wiem	viə̯m
wien	viə̯n
wierdeg	viɐ̯dəɕ
wiere	viə̯ʁə
wieren	viə̯ʁən
wierfel	viɐ̯fəl
wierfele	viɐ̯fələ
wierfelen	viɐ̯fələn
Wierk	viɐ̯k
wierkdësch	viɐ̯kdəʃ
wierke	viɐ̯kə
wierken	viɐ̯kən
wierklech	viɐ̯kləɕ
Wierklechkeet	viɐ̯kləɕkeːt
Wierkung	viɐ̯kuŋ
wierme	viɐ̯mə
wiermen	viɐ̯mən
wiermt	viɐ̯mt
wiers	viɐ̯s
wiert	viɐ̯t
Wiertchen	viɐ̯t͡ɕən
wiertes	viɐ̯təs
Wiertschaft	viɐ̯t͡ʃɑft
wierze	viɐ̯t͡sə
wierzen	viɐ̯t͡sən
wiessele	viə̯sələ
wiesselen	viə̯sələn
wiewe	viə̯və
wiewen	viə̯vən
wimmele	vimələ
wimmelen	vimələn
Wimper	vimpɐ
windjack	vintjɑk
Winker	viŋkɐ
winne	vinə
winnen	vinən
wirbelwand	viʁbəlvɑnt
wirschtche	viʁʃt͡ɕə
Wirschtchen	viʁʃt͡ɕən
Wischer	viʃɐ
Wise	viːzə
wisechampignon	viːzəʃɑ̃ːpiɲɑ̃ː
wisechampignone	viːzəʃɑ̃ːpiɲɑ̃ːə
wisechampignonen	viːzəʃɑ̃ːpiɲɑ̃ːən
wisefest	viːzəfæst
wisefester	viːzəfæstɐ
wisel	vizəl
Wiss	vis
Witfra	vitfʁaː
Witmann	vitmɑn
Witz	vit͡s
witzeg	vit͡səɕ
wo	voː
Woch	voχ
woe	voːə
woen	voːən
Woll	vol
Wollef	voləf
Wollek	volek
wollent	volənt
won	voːn
Wonn	von
Wonner	vonɐ
wonnerbar	vonɐbaːʁ
wonnerbare	vonɐbaːʁə
wonnerbart	vonɐbaːʁt
wonnere	vonəʁə
wonneren	vonəʁən
wonnerschéin	vonɐʃɜɪ̯n
Wonnerwierk	vonɐviɐ̯k
Wonsch	vonʃ
woodlech	voːdləɕ
Wope	voːp
Wopen	voːpən
wopendéier	voːpəndɜɪ̯ɐ
wopendéiere	voːpəndɜɪ̯əʁə
wopendéieren	voːpəndɜɪ̯əʁən
wou	vəʊ̯
wouduerjer	vəʊ̯duɐʑɐ
wouer	vəʊ̯ɐ
Wouerecht	vəʊ̯əʁəɕt
woumadder	vəʊ̯mɑdɐ
woumat	vəʊ̯mɑt
wourënner	vəʊ̯ʁənɐ
wourun	vəʊ̯ʁun
Wouscht	vəʊ̯ʃt
wouvun	vəʊ̯fun
Wrack	vʁɑk
Wuecht	vuə̯ɕt
Wued	vuə̯t
wuel	vuə̯l
wuer	vuɐ
wuerfir	vuɐfiɐ̯
wuergéint	vuɐɡɜɪ̯nt
wuerhin	vuɐhin
Wuerm	vuɐm
wuert	vuɐt
Wuerzel	vuɐt͡səl
Wues	vuə̯s
wuesse	vuə̯sə
wuessen	vuə̯sən
wuesskräijonge	vuə̯skʁæːɪ̯joŋə
wuesskräijongen	vuə̯skʁæːɪ̯joŋən
Wuesstem	vuə̯stəm
Wull	vul
wunne	vunə
wunnen	vunən
Wunneng	vuneŋ
Wupp	vup
wurscht	vuʁʃt
Wüst	vyːst
xenophobem	kseːnoːfoːbəm
xenophoben	kseːnoːfoːbən
xenophober	kseːnoːfoːbɐ
Xenophobie	kseːnoːfoːbiː
xenophobt	kseːnoːfoːpt
xylofon	ksiloːfoːn
xylofone	ksiloːfoːnə
xylofonen	ksiloːfoːnən
xylofoner	ksiloːfonɐ
xylophon	ksiloːfoːn
xylophone	ksiloːfoːnə
xylophonen	ksiloːfoːnən
xylophoner	ksiloːfoːnɐ
Yoga	joːɡaː
yoghourt	joɡuʁt
Zaang	t͡saːŋ
zaart	t͡saːʁt
zack	t͡sɑk
zäertlech	t͡sɛːɐtləɕ
Zäertlechkeet	t͡sɛːɐtləɕkeːt
zahnstocher	t͡saːnʃtoχɐ
Zäit	t͡sæːɪ̯t
zäitgenëssesch	t͡sæːɪ̯tɡənəsəʃ
Zäitschrëft	t͡sæːɪ̯t͡ʃʁəft
zäitweileg	t͡sæːɪ̯tvɑɪ̯ləɕ
Zalot	t͡sɑloːt
zam	t͡saːm
zäme	t͡sɛːmə
zämen	t͡sɛːmən
zammermann	t͡sɑmɐmɑn
Zännbiischt	t͡sænbiːʃt
Zänndokter	t͡sændoktɐ
zännfleesch	t͡sænfleːʃ
Zännpasta	t͡sænpɑstaː
zännseef	t͡sænzeːf
zännstëppler	t͡sænʃtəplɐ
Zännwéi	t͡sænwɜɪ̯
Zant	t͡sɑnt
zanter	t͡sɑntɐ
zantimeter	t͡sɑntimeːtɐ
Zap	t͡saːp
zape	t͡saːpə
zapen	t͡saːpən
zappe	t͡sɑpə
zappen	t͡sɑpən
Zär	t͡sɛːʁ
zare	t͡saːʁ
zäsure	t͡sɛːsuːʁə
zäsuren	t͡sɛːzuːʁən
zaubere	t͡sɑʊ̯bəʁə
Zauberei	t͡sɑʊ̯bəʁɑɪ̯
zauberen	t͡sɑʊ̯bəʁən
ze	zə
Zebra	t͡seːbʁaː
Zebrasträif	t͡seːbʁaːstʁæːɪ̯f
zecke	t͡sækə
zécke	t͡sekə
zecken	t͡sækən
zécken	t͡sekən
zeder	t͡seːdɐ
zee	t͡seː
Zeeche	t͡seːɕə
Zeechen	t͡seːɕən
zeechne	t͡seːɕnə
zeechnen	t͡seːɕnən
Zeechner	t͡seːɕnɐ
Zeechnerin	t͡seːɕnəʁin
Zeechnung	t͡seːɕnuŋ
Zeen	t͡seːn
zefridde	t͡səfʁidə
zefridden	t͡səfʁidən
zeideg	t͡sɑɪ̯dəɕ
Zeie	t͡sɑɪ̯ə
zéie	t͡sɜɪ̯ə
zeien	t͡sɑɪ̯ən
zéien	t͡sɜɪ̯ən
Zéif	t͡sɜɪ̯f
Zeitung	t͡sɑɪ̯tuŋ
zejoer	t͡səjoɐ
zejoert	t͡səjoːɐt
zelebréiert	t͡selebʁɜɪ̯ɐt
zelleri	t͡sæləʁiː
Zelt	t͡sælt
Zement	t͡səmænt
Zëmmer	t͡səmɐ
zemol	t͡səmoːl
zemools	t͡səmoːls
zéng	t͡seŋ
zéngte	t͡seŋtə
zéngten	t͡seŋtən
zënn	t͡sən
Zensur	t͡sænzuːʁ
zensure	t͡sænzuːʁə
Zensuren	t͡sænzuːʁən
zënter	t͡səntɐ
zentral	t͡sæntʁaːl
zentrifugal	t͡sæntʁifuːɡaːl
zentrifugale	t͡sæntʁifuːɡaːlə
zentrifugalem	t͡sæntʁifuːɡaːləm
zentrifugalen	t͡sæntʁifuːɡaːlən
zentrifugaler	t͡sæntʁifuːɡaːlɐ
zentrifugéierter	t͡sæntʁifuːɡɜɪ̯ɐtɐ
zentrifugen	t͡sæntʁifuːʁən
Zentrum	t͡sæntʁum
zerbrieche	t͡sɐbʁiə̯ɕə
zerbriechen	t͡sɐbʁiə̯ɕən
zerbriechlech	t͡sɐbʁiə̯ɕləɕ
zerdrécke	t͡sɐdʁekə
zerdrécken	t͡sɐdʁekən
Zeremonie	t͡seʁemoniː
zeremonië	t͡seʁemoniːə
Zeremonien	t͡seʁemoniːən
zerfatzt	t͡sɐfɑt͡st
zeriet	t͡səʁiə̯t
zerkniwwele	t͡sɐknivələ
zerkniwwelen	t͡sɐknivələn
zerkraazt	t͡sɐkʁaːt͡st
zermuele	t͡sɐmuə̯lə
zermuelen	t͡sɐmuə̯lən
zerquetsche	t͡sɐkwæt͡ʃə
zerquetschen	t͡sɐkwæt͡ʃən
zerräisse	t͡sɐʁæːɪ̯sə
zerräissen	t͡sɐʁæːɪ̯sən
zerrappe	t͡sɐʁɑpə
zerrappen	t͡sɐʁɑpən
zersaten	t͡sɐzaːtən
zersater	t͡sɐzaːtɐ
zerschloe	t͡sɐʃloːə
zerschloen	t͡sɐʃloːən
zerseetem	t͡sɐzeːtəm
zerseeten	t͡sɐzeːtən
zerseeter	t͡sɐzeːtɐ
zersidelt	t͡sɐziːdəlt
zersidelte	t͡sɐziːdəltə
zersideltem	t͡sɐzidəltəm
zerstéiere	t͡sɐʃtɜɪ̯əʁə
zerstéieren	t͡sɐʃtɜɪ̯əʁən
zerstreet	t͡sɐʃtʁeːt
zertéitschter	t͡sɐtɜɪ̯t͡ʃtɐ
zertifika	t͡sɛʁtifikaː
Zertifikat	t͡sɛʁtifikaːt
Zertifikater	t͡sɛʁtifikaːtɐ
zerwéiere	t͡sɛʁvɜɪ̯ɐə
zerwéieren	t͡sɛʁvɜɪ̯ɐən
zerwéit	t͡sɛʁvɜɪ̯t
zerwiss	t͡sɛʁvis
Zerwisser	t͡sɛʁvisɐ
zerwujel	t͡sɐvuʑəl
zerwujele	t͡sɐvuʑələ
zerwujelen	t͡sɐvuʑələn
zerwujels	t͡sɐvuʑəls
zerwullte	t͡sɐvultə
zerwulltem	t͡sɐvultəm
zerwullten	t͡sɐvultən
zerwullter	t͡sɐvultɐ
zësse	t͡səsə
zëssen	t͡səsən
zesumme	t͡səzumə
zesummebrieche	t͡səzuməbʁiə̯ɕə
zesummebriechen	t͡səzuməbʁiə̯ɕən
zesummegepecht	t͡səzuməɡəpæɕt
zesummegepechte	t͡səzuməɡəpæɕtə
zesummen	t͡səzumən
zesummepeche	t͡səzuməpæɕə
zesummepechen	t͡səzuməpæɕən
zesummeschäre	t͡səzuməʃɛːʁə
zesummeschären	t͡səzuməʃɛːʁən
zesummesetze	t͡səzuməsæt͡sə
zesummesetzen	t͡səzuməsæt͡sən
zetär	t͡sətɛːʁ
zevirkoums	t͡səfiɐ̯kəʊ̯ms
zevirkoumt	t͡səfiɐ̯kəʊ̯mt
zevirzekomme	t͡səfiɐ̯t͡səkomə
zevirzekommen	t͡səfiɐ̯t͡səkomən
ziddere	t͡sidəʁə
zidderen	t͡sidəʁən
Ziedel	t͡siə̯dəl
ziele	t͡siə̯lə
zielen	t͡siə̯lən
zierkel	t͡siɐ̯kəl
Ziffer	t͡sifɐ
zifferblat	t͡sifɐblaːt
Zigar	t͡siɡaːʁ
zigare	t͡siɡaːʁ
Zigaren	t͡siɡaːʁən
Zigarett	t͡siɡɑʁæt
zigel	t͡siʑəl
ziicht	t͡siːɕt
ziichte	t͡siːɕtə
ziichten	t͡siːɕtən
Zil	t͡siːl
Zill	t͡sil
Zille	t͡silə
zillen	t͡silən
Zilscheif	t͡siːlʃɑɪ̯f
zimlech	t͡simləɕ
Zinema	t͡sinemaː
zinnober	t͡sinoːbɐ
zirkuléiere	t͡siʁkulɜɪ̯əʁə
zirkuléieren	t͡siʁkulɜɪ̯əʁən
Zirkus	t͡siʁkus
zitadell	t͡sitɑdæl
zitadelle	t͡sitɑdælə
zitadellen	t͡sitɑdælən
zitéiere	t͡sitɜɪ̯əʁə
zitéieren	t͡sitɜɪ̯əʁən
Zitroun	t͡sitʁəʊ̯n
zivilsten	t͡sivilstən
zivilster	t͡sivilstɐ
zivilt	t͡sivilt
ziwwi	t͡siviː
ziwwie	t͡siviːə
Zocker	t͡sokɐ
zockerboun	t͡sokɐbəʊ̯n
zockerdëppche	t͡sokɐdəpɕə
zockerdëppchen	t͡sokɐdəpɕən
zockerwatt	t͡sokɐvɑt
Zodi	t͡soːdiː
zolidd	t͡solit
Zomm	t͡som
Zon	t͡soːn
zone	t͡soːnə
Zonen	t͡soːnən
Zong	t͡soŋ
Zoo	t͡soː
zooen	t͡soːən
zoolog	t͡soːloːk
zoologe	t͡soːloːɡə
zoologen	t͡soːloːɡən
zoologin	t͡soːloːɡin
zoologinne	t͡soːoːloːɡinə
zoologinnen	t͡soːoːloːɡinən
Zoom	zuːm
zoome	zuːmə
zoomen	zuːmən
zooms	zuːms
zoomt	zuːmt
Zooss	t͡soːs
Zoossiss	t͡soːsis
Zopp	t͡sop
zoppeläffel	t͡sopəlæfəl
zort	t͡sɔʁt
zou	t͡səʊ̯
zoudecke	t͡səʊ̯dækə
zoudecken	t͡səʊ̯dækən
zoudréie	t͡səʊ̯dʁɜɪ̯ə
zoudréien	t͡səʊ̯dʁɜɪ̯ən
Zoufall	t͡səʊ̯fɑl
zoufälleg	t͡səʊ̯fæləɕ
zougänglech	t͡səʊ̯ɡæŋləɕ
Zougank	t͡səʊ̯ɡɑŋk
zougestoe	t͡səʊ̯ɡəʃtoːə
zougestoen	t͡səʊ̯ɡəʃtoːən
zougi	t͡səʊ̯ɡi
zouginn	t͡səʊ̯ɡin
zouhuele	t͡səʊ̯huə̯lə
zouhuelen	t͡səʊ̯huə̯lən
zoukënfteg	t͡səʊ̯kənftəɕ
zouknäppe	t͡səʊ̯knæpə
zouknäppen	t͡səʊ̯knæpən
Zoulaf	t͡səʊ̯laːf
Zoulag	t͡səʊ̯laːχ
zouléisseg	t͡səʊ̯lɜɪ̯səɕ
zousätzlech	t͡səʊ̯zæt͡sləɕ
Zouso	t͡səʊ̯soː
zouspäre	t͡səʊ̯ʃpɛːʁə
zouspären	t͡səʊ̯ʃpɛːʁən
Zoustand	t͡səʊ̯ʃtɑnt
zouverléisseg	t͡səʊ̯fɐlɜɪ̯səɕ
zrass	t͡sʁɑs
zréck	t͡sʁek
zréckbezuele	t͡sʁekbet͡suə̯lə
zréckbezuelen	t͡sʁekbet͡suə̯lən
zréckgi	t͡sʁekɡi
zréckginn	t͡sʁekɡin
zréckkomme	t͡sʁekkomə
zréckkommen	t͡sʁekkomən
zréckkréie	t͡sʁekkʁɜɪ̯ə
zréckkréien	t͡sʁekkʁɜɪ̯ən
zréckschécke	t͡sʁekʃekə
zréckschécken	t͡sʁekʃekən
zrécksprange	t͡sʁekʃpʁɑŋə
zrécksprangen	t͡sʁekʃpʁɑŋən
zrécktriede	t͡sʁektʁiə̯də
zrécktrieden	t͡sʁektʁiə̯dən
zréckzéie	t͡sʁekt͡sɜɪ̯ə
zréckzéien	t͡sʁekt͡sɜɪ̯ən
Zuch	t͡suχ
Zuel	t͡suə̯l
zukënfteg	t͡suːkənftəɕ
Zukunft	t͡suːkunft
zündung	t͡synduŋ
Zwang	t͡swɑŋ
zwanzeg	t͡swɑnt͡səɕ
zwar	t͡swaːʁ
Zweck	t͡swæk
zwee	t͡sweː
zweedeiteg	t͡sweːdɑɪ̯təɕ
zweemol	t͡sweːmoːl
zweete	t͡sweːtə
zweeten	t͡sweːtən
zweetrangeg	t͡sweːtʁɑŋəɕ
zwéin	t͡swɜɪ̯n
Zweiwel	t͡swɑɪ̯vəl
zweiwele	t͡swɑɪ̯vələ
zweiwelen	t͡swɑɪ̯vələn
zweiwelhaft	t͡swɑɪ̯vəlhɑft
zwénge	t͡sweŋə
zwéngen	t͡sweŋən
Zwerg	t͡swɛʁɕ
Zwerge	t͡swɛʁɕə
Zwergen	t͡swɛʁʑən
zwëschefall	t͡swəʃəfɑl
zwëschegelant	t͡swəʃəɡəlɑnt
zwielef	t͡swiə̯ləf
Zwillinge	t͡swiliŋə
Zwillingen	t͡swiliŋən
zwir	t͡swiɐ̯
zwire	t͡swiːʁə
zwiren	t͡swiːʁən
zwirer	t͡swiːʁɐ
zwispältegen	t͡swiːspæltəʑən
zwispältegster	t͡swiːspæltəɕstɐ
zwispältegt	t͡swiːspæltəɕt
zwiwwel	t͡swivəl
zwou	t͡swəʊ̯
zykle	t͡sikəl
Zyklen	t͡siklən
zyklesch	t͡sikləʃ
zykleschen	t͡sikləʃən
zyklescher	t͡sikləʃɐ
zyklescht	t͡sikləʃt
Zyklus	t͡siklus
zyklusse	t͡siklusə
zyklussen	t͡siklusən
Zylinder	t͡silindɐ
zynesch	t͡siːnəʃ
zynescht	t͡siːnəʃt
Zyniker	t͡siːnikɐ
zynikerin	t͡siːnikəʁin
zynikerinne	t͡siːnikəʁinə
zynikerinnen	t͡siːnikəʁinən
Zynismus	t͡sinismus
zypress	t͡sipʁæs
